Codigo;UF;Municipios;Pop2000;Homens;Mulheres;Urbana;Rural;Pop2010;Pop2021
1100015;RO;Alta Floresta DOeste;26533;12670;11752;13992;10430;24422;22516
1100023;RO;Ariquemes;74503;45538;44816;69606;20748;90354;111148
1100031;RO;Cabixi;7518;3262;3047;2693;3616;6309;5067
1100049;RO;Cacoal;73568;39155;39446;61931;16670;78601;86416
1100056;RO;Cerejeiras;18207;8552;8478;14420;2610;17030;16088
1100064;RO;Colorado do Oeste;21892;9333;9269;13666;4936;18602;15213
1100072;RO;Corumbiara;10459;4722;4080;2590;6212;8802;7052
1100080;RO;Costa Marques;10208;7209;6491;7504;6196;13700;19255
1100098;RO;Espigão DOeste;25688;14633;14108;20629;8112;28741;33009
1100106;RO;Guajará-Mirim;38045;20940;20706;35197;6449;41646;46930
1100114;RO;Jaru;53600;26037;26006;35141;16902;52043;51469
1100122;RO;Ji-Paraná;106800;57834;58753;104841;11746;116587;131026
1100130;RO;Machadinho DOeste;22739;16519;14588;16176;14931;31107;41724
1100148;RO;Nova Brasilândia DOeste;17067;10328;9517;8370;11475;19845;20504
1100155;RO;Ouro Preto do Oeste;40884;18709;19232;28208;9733;37941;35445
1100189;RO;Pimenta Bueno;31752;17010;16744;29358;4396;33754;37098
1100205;RO;Porto Velho;334661;215561;210997;391014;35544;426558;548952
1100254;RO;Presidente Médici;26365;11316;11003;13296;9023;22319;18165
1100262;RO;Rio Crespo;2937;1767;1549;1064;2252;3316;3843
1100288;RO;Rolim de Moura;47382;25178;25494;41454;9218;50672;55748
1100296;RO;Santa Luzia DOeste;11603;4596;4290;4525;4361;8886;5942
1100304;RO;Vilhena;53598;37779;38408;72212;3975;76187;104517
1100320;RO;São Miguel do Guaporé;23874;11327;10497;8471;13353;21824;23147
1100338;RO;Nova Mamoré;14778;11738;10814;13069;9483;22552;32184
1100346;RO;Alvorada DOeste;19832;8677;8187;8837;8027;16864;13807
1100379;RO;Alto Alegre dos Parecis;12708;6746;6080;3665;9161;12826;13268
1100403;RO;Alto Paraíso;13118;9025;8119;8216;8928;17144;22258
1100452;RO;Buritis;25668;16746;15639;18113;14272;32385;41043
1100502;RO;Novo Horizonte do Oeste;12276;5333;4904;1732;8505;10237;8125
1100601;RO;Cacaulândia;5372;2960;2767;2068;3659;5727;6307
1100700;RO;Campo Novo de Rondônia;11463;6770;5899;3371;9298;12669;14391
1100809;RO;Candeias do Jamari;13107;10327;9455;12898;6884;19782;28068
1100908;RO;Castanheiras;4212;1831;1750;842;2739;3581;2923
1100924;RO;Chupinguaia;5521;4409;3895;3670;4634;8304;11755
1100940;RO;Cujubim;6536;8476;7397;11065;4808;15873;27131
1101005;RO;Governador Jorge Teixeira;13641;5471;5042;2361;8152;10513;7130
1101104;RO;Itapuã do Oeste;6822;4563;3998;5220;3341;8561;10819
1101203;RO;Ministro Andreazza;11342;5306;5048;3074;7280;10354;9461
1101302;RO;Mirante da Serra;13154;6057;5812;6432;5437;11869;10691
1101401;RO;Monte Negro;12627;7407;6683;7387;6703;14090;16158
1101435;RO;Nova União;8233;4003;3495;1540;5958;7498;6822
1101450;RO;Parecis;3622;2596;2214;1774;3036;4810;6319
1101468;RO;Pimenteiras do Oeste;2527;1223;1099;1297;1025;2322;2127
1101476;RO;Primavera de Rondônia;4311;1856;1667;1282;2241;3523;2697
1101484;RO;São Felipe DOeste;7056;3086;2932;1444;4574;6018;4962
1101492;RO;São Francisco do Guaporé;11085;8410;7609;8227;7792;16019;21088
1101500;RO;Seringueiras;11655;6090;5559;4407;7242;11649;11846
1101559;RO;Teixeirópolis;5618;2544;2349;1718;3175;4893;4160
1101609;RO;Theobroma;11140;5649;4995;1980;8664;10644;10348
1101708;RO;Urupá;14880;6729;6240;5141;7828;12969;11081
1101757;RO;Vale do Anari;7737;4972;4389;3184;6177;9361;11545
1101807;RO;Vale do Paraíso;9863;4249;3969;2276;5942;8218;6490
1200013;AC;Acrelândia;7935;6597;5941;5916;6622;12538;15721
1200054;AC;Assis Brasil;3490;3091;2984;3703;2372;6075;7649
1200104;AC;Brasiléia;17013;11060;10378;14299;7139;21438;27123
1200138;AC;Bujari;5826;4560;3914;3681;4793;8474;10572
1200179;AC;Capixaba;5206;4658;4152;3928;4882;8810;12280
1200203;AC;Cruzeiro do Sul;67441;39185;39259;55259;23185;78444;89760
1200252;AC;Epitaciolândia;11028;7636;7490;10622;4504;15126;18979
1200302;AC;Feijó;26722;16660;15651;16635;15676;32311;34986
1200328;AC;Jordão;4454;3396;3135;2265;4266;6531;8628
1200336;AC;Mâncio Lima;11095;7856;7390;8782;6464;15246;19643
1200344;AC;Manoel Urbano;6374;4256;3733;5285;2704;7989;9701
1200351;AC;Marechal Thaumaturgo;8295;7437;6763;3971;10229;14200;19727
1200385;AC;Plácido de Castro;15172;8997;8206;10390;6813;17203;20147
1200393;AC;Porto Walter;5485;4791;4381;3317;5855;9172;12497
1200401;AC;Rio Branco;253059;163396;172400;308418;27378;335796;419452
1200427;AC;Rodrigues Alves;8093;7450;6884;4325;10009;14334;19767
1200435;AC;Santa Rosa do Purus;2246;2373;2239;1894;2718;4612;6893
1200450;AC;Senador Guiomard;19761;10328;9825;12670;7483;20153;23446
1200500;AC;Sena Madureira;29420;19704;18289;25132;12861;37993;47168
1200609;AC;Tarauacá;26037;18317;17209;19363;16163;35526;43730
1200708;AC;Xapuri;11956;8310;7706;10270;5746;16016;19866
1200807;AC;Porto Acre;11418;7806;7000;1955;12851;14806;19141
1300029;AM;Alvarães;12150;7408;6672;7878;6202;14080;16396
1300060;AM;Amaturá;7308;4986;4671;4945;4712;9657;11934
1300086;AM;Anamã;6563;5434;4759;4174;6019;10193;14292
1300102;AM;Anori;11320;8497;7792;9989;6300;16289;21937
1300144;AM;Apuí;13864;9571;8488;10606;7453;18059;22739
1300201;AM;Atalaia do Norte;10049;7851;7298;6891;8258;15149;20868
1300300;AM;Autazes;24345;16829;15047;13885;17991;31876;41005
1300409;AM;Barcelos;24197;13814;11901;11160;14555;25715;27772
1300508;AM;Barreirinha;22579;14316;13045;12422;14939;27361;32919
1300607;AM;Benjamin Constant;23219;17246;16145;20132;13259;33391;44873
1300631;AM;Beruri;11038;8153;7347;7795;7705;15500;20503
1300680;AM;Boa Vista do Ramos;10482;7948;6973;7521;7400;14921;20040
1300706;AM;Boca do Acre;26959;15545;14335;19273;10607;29880;34958
1300805;AM;Borba;28619;17953;16499;14409;20043;34452;42328
1300839;AM;Caapiranga;8803;5776;5133;5140;5769;10909;13482
1300904;AM;Canutama;10737;6868;5859;6682;6045;12727;15981
1301001;AM;Carauari;23421;13195;12505;19754;5946;25700;28719
1301100;AM;Careiro;27554;16922;15709;9440;23191;32631;38820
1301159;AM;Careiro da Várzea;17267;12707;11256;1000;22963;23963;31459
1301209;AM;Coari;67096;39429;36480;49638;26271;75909;86713
1301308;AM;Codajás;17507;12029;11090;15808;7311;23119;29691
1301407;AM;Eirunepé;26074;15791;14875;22178;8488;30666;36121
1301506;AM;Envira;19060;8395;7933;10553;5775;16328;20748
1301605;AM;Fonte Boa;31509;11744;10915;15039;7620;22659;16409
1301654;AM;Guajará;13220;7340;6734;7457;6617;14074;17193
1301704;AM;Humaitá;32796;23115;21001;30475;13641;44116;57195
1301803;AM;Ipixuna;14759;11331;10868;9452;12747;22199;31172
1301852;AM;Iranduba;32303;20976;19759;28928;11807;40735;49718
1301902;AM;Itacoatiara;72105;44419;42421;58175;28665;86840;104046
1301951;AM;Itamarati;8406;4238;3802;4474;3566;8040;7777
1302009;AM;Itapiranga;7309;4297;3903;6447;1753;8200;9312
1302108;AM;Japurá;10285;3804;3485;3319;3970;7289;1755
1302207;AM;Juruá;6584;5564;5258;5686;5136;10822;15495
1302306;AM;Jutaí;22500;9416;8548;10559;7405;17964;13462
1302405;AM;Lábrea;28956;19586;17988;24223;13351;37574;47685
1302504;AM;Manacapuru;73695;43429;41715;60178;24966;85144;99613
1302553;AM;Manaquiri;12711;11747;11060;7068;15739;22807;33981
1302603;AM;Manaus;1405835;879893;922632;1793416;9109;1802525;2255903
1302702;AM;Manicoré;38038;24681;22330;20347;26664;47011;57405
1302801;AM;Maraã;17079;9339;8025;8759;8605;17364;18298
1302900;AM;Maués;40036;27084;24763;25836;26011;51847;66159
1303007;AM;Nhamundá;15355;9496;8782;7010;11268;18278;21710
1303106;AM;Nova Olinda do Norte;23725;15782;14979;13648;17113;30761;38665
1303205;AM;Novo Airão;9651;7655;7125;9490;5290;14780;20395
1303304;AM;Novo Aripuanã;17119;11405;9984;14079;7310;21389;26443
1303403;AM;Parintins;90150;52318;49748;69905;32161;102066;116439
1303502;AM;Pauini;17092;9485;8668;9264;8889;18153;19616
1303536;AM;Presidente Figueiredo;17394;14321;12800;12999;14122;27121;38095
1303569;AM;Rio Preto da Eva;17582;13416;12342;12244;13514;25758;34856
1303601;AM;Santa Isabel do Rio Negro;10561;9315;8818;6858;11275;18133;26566
1303700;AM;Santo Antônio do Içá;28213;12591;11896;12954;11533;24487;20889
1303809;AM;São Gabriel da Cachoeira;29947;19144;18156;19001;18299;37300;47031
1303908;AM;São Paulo de Olivença;23113;16268;15158;14267;17159;31426;40837
1303957;AM;São Sebastião do Uatumã;7160;5670;5018;5907;4781;10688;14678
1304005;AM;Silves;7785;4500;3945;4033;4412;8445;9289
1304062;AM;Tabatinga;37919;26347;25932;36371;15908;52279;68502
1304104;AM;Tapauá;20595;10075;9002;10618;8459;19077;16876
1304203;AM;Tefé;64457;31492;29907;50072;11327;61399;59250
1304237;AM;Tonantins;15512;8767;8289;8903;8153;17056;19038
1304260;AM;Uarini;10254;6319;5587;6799;5107;11906;13839
1304302;AM;Urucará;18372;8829;8190;9868;7151;17019;16007
1304401;AM;Urucurituba;12264;9467;8264;10355;7376;17731;24098
1400027;RR;Amajari;5294;4995;4335;1219;8111;9330;13561
1400050;RR;Alto Alegre;17907;8592;7694;4780;11506;16286;15249
1400100;RR;Boa Vista;200568;140808;143450;277754;6504;284258;436591
1400159;RR;Bonfim;9326;5883;5068;3716;7235;10951;12701
1400175;RR;Cantá;8571;7470;6308;2257;11521;13778;19257
1400209;RR;Caracaraí;14286;9725;8659;10889;7495;18384;22635
1400233;RR;Caroebe;5692;4309;3805;3324;4790;8114;10595
1400282;RR;Iracema;4781;4593;4083;4078;4598;8676;12637
1400308;RR;Mucajaí;11247;7872;6942;8944;5870;14814;18482
1400407;RR;Normandia;6138;4670;4256;2311;6615;8926;11772
1400456;RR;Pacaraima;6990;5418;5030;4516;5932;10448;20108
1400472;RR;Rorainópolis;17393;13672;11915;10679;14908;25587;31387
1400506;RR;São João da Baliza;5091;3556;3222;4775;2003;6778;8492
1400605;RR;São Luiz;5311;3568;3182;4455;2295;6750;8232
1400704;RR;Uiramutã;5802;4212;3935;1083;7064;8147;11014
1500107;PA;Abaetetuba;119152;71612;69442;82950;58104;141054;160439
1500131;PA;Abel Figueiredo;5957;3542;3250;6046;746;6792;7536
1500206;PA;Acará;52126;28139;25466;12625;40980;53605;55744
1500305;PA;Afuá;29505;18449;16568;9478;25539;35017;39910
1500347;PA;Água Azul do Norte;22084;13618;11443;4876;20185;25061;27797
1500404;PA;Alenquer;41784;27086;25628;27774;24940;52714;57390
1500503;PA;Almeirim;33957;17502;16163;19972;13693;33665;34044
1500602;PA;Altamira;77439;52814;52216;90068;14962;105030;117320
1500701;PA;Anajás;18322;12968;11803;9492;15279;24771;30091
1500800;PA;Ananindeua;393569;226537;245207;470590;1154;471744;540410
1500859;PA;Anapu;9407;10965;9528;9840;10653;20493;29312
1500909;PA;Augusto Corrêa;33011;20994;19505;18237;22262;40499;46937
1500958;PA;Aurora do Pará;19728;13630;12949;8174;18405;26579;32200
1501006;PA;Aveiro;15518;8319;7448;3182;12585;15767;16421
1501105;PA;Bagre;13708;12136;11719;10652;13203;23855;31967
1501204;PA;Baião;21119;19450;17457;18555;18352;36907;49454
1501253;PA;Bannach;3780;1849;1585;1284;2150;3434;3239
1501303;PA;Barcarena;63268;50379;49421;36357;63443;99800;129333
1501402;PA;Belém;1280614;658188;733843;1380836;11195;1392031;1506420
1501451;PA;Belterra;14594;8483;7841;6853;9471;16324;17944
1501501;PA;Benevides;35546;25824;25839;28907;22756;51663;64780
1501576;PA;Bom Jesus do Tocantins;13106;8028;7218;8160;7086;15246;17254
1501600;PA;Bonito;9814;7114;6516;3827;9803;13630;16769
1501709;PA;Bragança;93779;57244;55921;72595;40570;113165;130122
1501725;PA;Brasil Novo;17193;9627;8333;6912;11048;17960;14883
1501758;PA;Brejo Grande do Araguaia;7464;3836;3488;4320;3004;7324;7357
1501782;PA;Breu Branco;32446;27090;25407;29303;23194;52497;68597
1501808;PA;Breves;80158;47780;45085;46561;46304;92865;104280
1501907;PA;Bujaru;21032;13338;12362;8099;17601;25700;29717
1501956;PA;Cachoeira do Piriá;15437;13710;12766;5523;20953;26476;35307
1502004;PA;Cachoeira do Arari;15783;10552;9908;7365;13095;20460;24355
1502103;PA;Cametá;97624;62023;58881;52846;68058;120904;140814
1502152;PA;Canaã dos Carajás;10922;13589;13138;20738;5989;26727;39103
1502202;PA;Capanema;57119;31496;32132;50736;12892;63628;69828
1502301;PA;Capitão Poço;49769;26618;25281;21447;30452;51899;54545
1502400;PA;Castanhal;134496;84421;88675;153321;19775;173096;205667
1502509;PA;Chaves;17350;11216;9922;2500;18638;21138;24175
1502608;PA;Colares;10632;5881;5501;3662;7720;11382;12175
1502707;PA;Conceição do Araguaia;43386;23313;22217;32452;13078;45530;48115
1502756;PA;Concórdia do Pará;20956;14591;13630;15091;13130;28221;34236
1502764;PA;Cumaru do Norte;5978;6087;4391;2737;7741;10478;14044
1502772;PA;Curionópolis;19486;9672;8623;12528;5767;18295;17764
1502806;PA;Curralinho;20016;15073;13509;10938;17644;28582;35530
1502855;PA;Curuá;9224;6456;5806;5781;6481;12262;14776
1502905;PA;Curuçá;26160;17647;16843;12210;22280;34490;41093
1502939;PA;Dom Eliseu;39529;26629;24689;32517;18801;51318;61206
1502954;PA;Eldorado dos Carajás;29608;16800;14945;16589;15156;31745;34069
1503002;PA;Faro;10037;4240;3941;6140;2041;8181;6949
1503044;PA;Floresta do Araguaia;14284;9549;8276;8736;9089;17825;20742
1503077;PA;Garrafão do Norte;24221;13112;11939;8614;16437;25051;26155
1503093;PA;Goianésia do Pará;22685;15750;14687;21083;9354;30437;41678
1503101;PA;Gurupá;23098;15402;13658;9580;19480;29060;34127
1503200;PA;Igarapé-Açu;32400;18082;17761;21210;14633;35843;39234
1503309;PA;Igarapé-Miri;52604;29661;28362;26209;31814;58023;63367
1503408;PA;Inhangapi;7681;5190;4874;2769;7295;10064;12009
1503457;PA;Ipixuna do Pará;25138;26944;24439;12228;39155;51383;67170
1503507;PA;Irituia;30518;16288;15094;6509;24873;31382;32639
1503606;PA;Itaituba;94750;49612;47731;70602;26741;97343;101541
1503705;PA;Itupiranga;49655;27033;24225;20478;30780;51258;53439
1503754;PA;Jacareacanga;24024;8009;6031;4933;9107;14040;6952
1503804;PA;Jacundá;40546;25770;25605;45702;5673;51375;60517
1503903;PA;Juruti;31198;24615;22508;15843;31280;47123;59961
1504000;PA;Limoeiro do Ajuru;19564;13119;11909;6198;18830;25028;29623
1504059;PA;Mãe do Rio;25351;13741;14151;23036;4856;27892;30389
1504109;PA;Magalhães Barata;7693;4258;3857;3795;4320;8115;8598
1504208;PA;Marabá;168020;118148;115314;186122;47340;233462;287664
1504307;PA;Maracanã;27571;14694;13682;11659;16717;28376;29559
1504406;PA;Marapanim;24718;13864;12741;11711;14894;26605;28563
1504422;PA;Marituba;74429;53880;54371;107129;1122;108251;135812
1504455;PA;Medicilândia;21379;14966;12476;9622;17820;27442;32347
1504505;PA;Melgaço;21064;13208;11581;5499;19290;24789;28121
1504604;PA;Mocajuba;20542;13756;12989;18297;8448;26745;31917
1504703;PA;Moju;52941;36624;33297;25118;44803;69921;84251
1504752;PA;Mojuí dos Campos;0;0;0;0;0;0;16282
1504802;PA;Monte Alegre;61334;28487;26972;24575;30884;55459;58289
1504901;PA;Muaná;25467;17916;16321;14523;19714;34237;41454
1504950;PA;Nova Esperança do Piriá;18893;10645;9514;7972;12187;20159;21519
1504976;PA;Nova Ipixuna;11866;7729;6916;7724;6921;14645;17027
1505007;PA;Nova Timboteua;11406;7080;6580;5517;8143;13660;15646
1505031;PA;Novo Progresso;24948;13413;11693;17705;7401;25106;25769
1505064;PA;Novo Repartimento;41817;32768;29356;28065;34059;62124;78488
1505106;PA;Óbidos;46490;25500;23754;25414;23840;49254;52473
1505205;PA;Oeiras do Pará;23255;15017;13578;11432;17163;28595;33182
1505304;PA;Oriximiná;48332;31794;31169;40182;22781;62963;74921
1505403;PA;Ourém;14397;8440;7856;7438;8858;16296;18079
1505437;PA;Ourilândia do Norte;19471;14379;13185;19931;7633;27564;33831
1505486;PA;Pacajá;28888;21599;18453;13752;26300;40052;49110
1505494;PA;Palestina do Pará;7544;3883;3604;4572;2915;7487;7575
1505502;PA;Paragominas;76450;49263;48525;76478;21310;97788;115838
1505536;PA;Parauapebas;71568;77866;76076;138769;15173;153942;218787
1505551;PA;Pau DArco;7124;3176;2853;3641;2388;6029;5339
1505601;PA;Peixe-Boi;7760;4047;3821;4184;3684;7868;8084
1505635;PA;Piçarra;12671;6778;5925;3581;9122;12703;12976
1505650;PA;Placas;13394;12562;11368;4856;19074;23930;32325
1505700;PA;Ponta de Pedras;18694;13379;12610;12429;13560;25989;32007
1505809;PA;Portel;38043;26817;25349;24846;27320;52166;63831
1505908;PA;Porto de Moz;23545;17612;16339;14586;19365;33951;42456
1506005;PA;Prainha;27301;15475;13790;8954;20311;29265;29827
1506104;PA;Primavera;9718;5303;4965;6395;3873;10268;10889
1506112;PA;Quatipuru;10905;6461;5950;5313;7098;12411;13794
1506138;PA;Redenção;63251;37944;37561;69994;5511;75505;86326
1506161;PA;Rio Maria;17498;9174;8548;13536;4186;17722;18208
1506187;PA;Rondon do Pará;39870;24276;22698;34704;12270;46974;53242
1506195;PA;Rurópolis;24660;20870;19198;15275;24793;40068;52473
1506203;PA;Salinópolis;33449;19097;18333;33400;4030;37430;41164
1506302;PA;Salvaterra;15118;10292;9892;12681;7503;20184;24392
1506351;PA;Santa Bárbara do Pará;11378;8763;8391;5456;11698;17154;21811
1506401;PA;Santa Cruz do Arari;5255;4145;4018;4001;4162;8163;10496
1506500;PA;Santa Isabel do Pará;43227;31174;28302;42996;16480;59476;72856
1506559;PA;Santa Luzia do Pará;19400;9882;9540;8691;10731;19422;19839
1506583;PA;Santa Maria das Barreiras;10955;9489;7709;6351;10847;17198;22244
1506609;PA;Santa Maria do Pará;20850;11493;11540;13335;9698;23033;25127
1506708;PA;Santana do Araguaia;31218;29743;26389;29651;26481;56132;75995
1506807;PA;Santarém;262538;145651;149123;215947;78827;294774;308339
1506906;PA;Santarém Novo;5434;3214;2931;1813;4332;6145;6796
1507003;PA;Santo Antônio do Tauá;19835;13440;13233;14873;11800;26673;32346
1507102;PA;São Caetano de Odivelas;15595;8806;8085;6958;9933;16891;18207
1507151;PA;São Domingos do Araguaia;20005;11922;11218;15262;7878;23140;25945
1507201;PA;São Domingos do Capim;27405;15738;14089;6599;23228;29827;32285
1507300;PA;São Félix do Xingu;34621;48650;42643;45134;46159;91293;135732
1507409;PA;São Francisco do Pará;14245;7847;7349;5206;9990;15196;15978
1507458;PA;São Geraldo do Araguaia;27646;13077;12507;13601;11983;25584;24566
1507466;PA;São João da Ponta;4035;2739;2526;1031;4234;5265;6294
1507474;PA;São João de Pirabas;17484;10763;9881;10486;10158;20644;23440
1507508;PA;São João do Araguaia;12247;7132;6017;2583;10566;13149;14105
1507607;PA;São Miguel do Guamá;41366;25996;25531;31852;19675;51527;60268
1507706;PA;São Sebastião da Boa Vista;17664;11831;11059;9907;12983;22890;27302
1507755;PA;Sapucaia;3796;2710;2337;3325;1722;5047;6088
1507805;PA;Senador José Porfírio;15721;6968;6030;6475;6523;12998;11305
1507904;PA;Soure;19958;11477;11518;21009;1986;22995;25752
1507953;PA;Tailândia;38435;40991;38308;58715;20584;79299;111554
1507961;PA;Terra Alta;8261;5272;4982;4334;5920;10254;11971
1507979;PA;Terra Santa;14592;8794;8158;10340;6612;16952;19063
1508001;PA;Tomé-Açu;47273;29327;27187;31646;24868;56514;64604
1508035;PA;Tracuateua;22743;14329;13137;7266;20200;27466;31549
1508050;PA;Trairão;14042;9154;7731;5687;11198;16885;19344
1508084;PA;Tucumã;25309;17448;16203;26862;6789;33651;40661
1508100;PA;Tucuruí;73798;48381;48728;92433;4676;97109;116605
1508126;PA;Ulianópolis;19254;22208;21137;28529;14816;43345;62286
1508159;PA;Uruará;45201;23604;21116;24405;20315;44720;45395
1508209;PA;Vigia;40176;24555;23347;32362;15540;47902;54650
1508308;PA;Viseu;51090;29794;26887;18392;38289;56681;62093
1508357;PA;Vitória do Xingu;11142;7294;6186;5361;8119;13480;15421
1508407;PA;Xinguara;35220;20572;20001;31492;9081;40573;45416
1600055;AP;Serra do Navio;3293;2335;2074;2575;1834;4409;5577
1600105;AP;Amapá;7121;4186;3819;6926;1079;8005;9265
1600154;AP;Pedra Branca do Amapari;4009;5833;4940;5970;4803;10773;17625
1600204;AP;Calçoene;6730;4795;4169;7301;1663;8964;11493
1600212;AP;Cutias;3280;2393;2241;2409;2225;4634;6217
1600238;AP;Ferreira Gomes;3562;3033;2739;4161;1611;5772;8151
1600253;AP;Itaubal;2894;2317;1950;1766;2501;4267;5730
1600279;AP;Laranjal do Jari;28515;20350;19455;37824;1981;39805;52302
1600303;AP;Macapá;283308;195497;202416;380937;16976;397913;522357
1600402;AP;Mazagão;11986;8977;8053;8280;8750;17030;22468
1600501;AP;Oiapoque;12886;10666;9760;13873;6553;20426;28534
1600535;AP;Porto Grande;11042;8903;7922;10759;6066;16825;22927
1600550;AP;Pracuúba;2286;1990;1793;1867;1916;3783;5370
1600600;AP;Santana;80439;50361;50842;99094;2109;101203;124808
1600709;AP;Tartarugalzinho;7121;6599;5836;6501;5934;12435;18217
1600808;AP;Vitória do Jari;8560;6439;6006;10318;2127;12445;16572
1700251;TO;Abreulândia;2189;1258;1129;1476;911;2387;2609
1700301;TO;Aguiarnópolis;3145;2617;2541;4138;1020;5158;7049
1700350;TO;Aliança do Tocantins;6177;2899;2764;4756;907;5663;5303
1700400;TO;Almas;8474;3973;3622;6016;1579;7595;6905
1700707;TO;Alvorada;8508;4256;4124;7771;609;8380;8381
1701002;TO;Ananás;10512;4985;4888;8151;1722;9873;9435
1701051;TO;Angico;2889;1669;1500;1937;1232;3169;3475
1701101;TO;Aparecida do Rio Negro;3517;2168;2045;3313;900;4213;4901
1701309;TO;Aragominas;6180;3138;2744;2230;3652;5882;5705
1701903;TO;Araguacema;5414;3331;2986;2925;3392;6317;7223
1702000;TO;Araguaçu;9346;4513;4273;5882;2904;8786;8418
1702109;TO;Araguaína;113143;73605;76915;142963;7557;150520;186245
1702158;TO;Araguanã;4193;2586;2444;3386;1644;5030;5856
1702208;TO;Araguatins;26010;15966;15358;20136;11188;31324;36573
1702307;TO;Arapoema;7025;3447;3295;5455;1287;6742;6590
1702406;TO;Arraias;10984;5394;5249;7369;3274;10643;10502
1702554;TO;Augustinópolis;12964;8013;7952;13185;2780;15965;18870
1702703;TO;Aurora do Tocantins;3101;1774;1672;2482;964;3446;3809
1702901;TO;Axixá do Tocantins;8827;4600;4675;7621;1654;9275;9817
1703008;TO;Babaçulândia;10329;5568;4878;4931;5515;10446;10668
1703057;TO;Bandeirantes do Tocantins;2608;1696;1428;1685;1439;3124;3631
1703073;TO;Barra do Ouro;3579;2195;1928;2186;1937;4123;4673
1703107;TO;Barrolândia;5082;2758;2588;4474;872;5346;5669
1703206;TO;Bernardo Sayão;4551;2332;2135;2190;2277;4467;4439
1703305;TO;Bom Jesus do Tocantins;2323;1990;1778;2826;942;3768;5120
1703602;TO;Brasilândia do Tocantins;1923;1058;1008;1438;628;2066;2221
1703701;TO;Brejinho de Nazaré;4877;2600;2588;4195;993;5188;5540
1703800;TO;Buriti do Tocantins;7842;4939;4831;7454;2316;9770;11644
1703826;TO;Cachoeirinha;2023;1137;1011;1731;417;2148;2293
1703842;TO;Campos Lindos;5638;4264;3875;4819;3320;8139;10505
1703867;TO;Cariri do Tocantins;2990;2105;1649;2091;1663;3754;4499
1703883;TO;Carmolândia;2008;1202;1103;1813;492;2305;2627
1703891;TO;Carrasco Bonito;3218;1920;1770;1969;1721;3690;4165
1703909;TO;Caseara;3660;2384;2217;2737;1864;4601;5514
1704105;TO;Centenário;2163;1375;1190;1504;1061;2565;2966
1704600;TO;Chapada de Areia;1270;716;619;749;586;1335;1415
1705102;TO;Chapada da Natividade;3274;1793;1487;1656;1624;3280;3330
1705508;TO;Colinas do Tocantins;25301;15310;15569;29649;1230;30879;36271
1705557;TO;Combinado;4524;2374;2295;4000;669;4669;4870
1705607;TO;Conceição do Tocantins;4377;2132;2050;2911;1271;4182;4070
1706001;TO;Couto Magalhães;4335;2638;2371;1884;3125;5009;5690
1706100;TO;Cristalândia;7318;3700;3518;5924;1294;7218;7268
1706258;TO;Crixás do Tocantins;1384;822;744;874;692;1566;1749
1706506;TO;Darcinópolis;4273;2775;2498;3489;1784;5273;6250
1707009;TO;Dianópolis;15428;9676;9434;16447;2663;19110;22704
1707108;TO;Divinópolis do Tocantins;5776;3280;3083;4466;1897;6363;6986
1707207;TO;Dois Irmãos do Tocantins;7269;3958;3203;2777;4384;7161;7173
1707306;TO;Dueré;4565;2440;2149;3055;1534;4589;4686
1707405;TO;Esperantina;7623;4910;4566;4614;4862;9476;11280
1707553;TO;Fátima;3848;1909;1896;3135;670;3805;3824
1707652;TO;Figueirópolis;5562;2705;2635;4054;1286;5340;5222
1707702;TO;Filadélfia;8218;4470;4032;5538;2964;8502;8892
1708205;TO;Formoso do Araguaia;18817;9608;8820;13333;5095;18428;18358
1708254;TO;Fortaleza do Tabocão;2242;1236;1187;1968;455;2423;2615
1708304;TO;Goianorte;4839;2651;2309;2764;2196;4960;5136
1709005;TO;Goiatins;11036;6287;5777;4949;7115;12064;13169
1709302;TO;Guaraí;20018;11693;11519;21132;2080;23212;26403
1709500;TO;Gurupi;65034;38113;38652;75014;1751;76765;88428
1709807;TO;Ipueiras;1166;864;775;958;681;1639;2088
1710508;TO;Itacajá;6815;3731;3373;4273;2831;7104;7471
1710706;TO;Itaguatins;6386;3106;2923;3396;2633;6029;5801
1710904;TO;Itapiratins;3277;1917;1617;1916;1618;3534;3814
1711100;TO;Itaporã do Tocantins;2522;1278;1161;1562;877;2439;2412
1711506;TO;Jaú do Tocantins;3121;1815;1692;1310;2197;3507;3906
1711803;TO;Juarina;2333;1175;1056;1033;1198;2231;2174
1711902;TO;Lagoa da Confusão;6168;5526;4689;6337;3878;10215;13989
1711951;TO;Lagoa do Tocantins;2530;1830;1695;2538;987;3525;4470
1712009;TO;Lajeado;2344;1464;1309;2166;607;2773;3199
1712157;TO;Lavandeira;1209;838;767;1023;582;1605;1984
1712405;TO;Lizarda;3787;2011;1720;2583;1148;3731;3727
1712454;TO;Luzinópolis;2021;1350;1272;1675;947;2622;3200
1712504;TO;Marianópolis do Tocantins;3332;2318;2034;2383;1969;4352;5332
1712702;TO;Mateiros;1646;1185;1034;1411;808;2219;2773
1712801;TO;Maurilândia do Tocantins;2854;1695;1463;2020;1138;3158;3470
1713205;TO;Miracema do Tocantins;24444;10344;10348;17945;2747;20692;17628
1713304;TO;Miranorte;11802;6422;6204;11039;1587;12626;13551
1713601;TO;Monte do Carmo;5193;3602;3115;2881;3836;6717;8182
1713700;TO;Monte Santo do Tocantins;1869;1120;965;450;1635;2085;2311
1713809;TO;Palmeiras do Tocantins;4622;2998;2748;3227;2519;5746;6830
1713957;TO;Muricilândia;2680;1657;1495;1800;1352;3152;3623
1714203;TO;Natividade;8867;4596;4404;7195;1805;9000;9256
1714302;TO;Nazaré;5150;2262;2124;1991;2395;4386;3772
1714880;TO;Nova Olinda;9385;5577;5109;7465;3221;10686;12014
1715002;TO;Nova Rosalândia;3190;1965;1805;2468;1302;3770;4348
1715101;TO;Novo Acordo;3057;1921;1841;3083;679;3762;4450
1715150;TO;Novo Alegre;2274;1180;1106;1699;587;2286;2332
1715259;TO;Novo Jardim;2151;1277;1180;1776;681;2457;2768
1715507;TO;Oliveira de Fátima;958;550;485;815;220;1035;1124
1715705;TO;Palmeirante;3610;2659;2295;1926;3028;4954;6234
1715754;TO;Palmeirópolis;7068;3707;3635;5984;1358;7342;7694
1716109;TO;Paraíso do Tocantins;36130;22122;22310;42485;1947;44432;52521
1716208;TO;Paranã;10416;5446;4889;4720;5615;10335;10426
1716307;TO;Pau DArco;4335;2459;2129;2900;1688;4588;4885
1716505;TO;Pedro Afonso;9028;5966;5576;10019;1523;11542;13964
1716604;TO;Peixe;8763;5429;4960;5236;5153;10389;11996
1716653;TO;Pequizeiro;4591;2666;2386;2390;2662;5052;5546
1716703;TO;Colméia;9352;4365;4242;6370;2237;8607;8078
1717008;TO;Pindorama do Tocantins;4685;2385;2121;2947;1559;4506;4414
1717206;TO;Piraquê;2360;1626;1294;1122;1798;2920;3038
1717503;TO;Pium;5540;3528;3168;3785;2911;6696;7830
1717800;TO;Ponte Alta do Bom Jesus;4574;2406;2142;2505;2043;4548;4586
1717909;TO;Ponte Alta do Tocantins;6172;3879;3301;4527;2653;7180;8192
1718006;TO;Porto Alegre do Tocantins;2393;1430;1365;1918;877;2795;3200
1718204;TO;Porto Nacional;44991;24521;24622;42439;6704;49143;53618
1718303;TO;Praia Norte;6781;3898;3763;4470;3191;7661;8563
1718402;TO;Presidente Kennedy;3759;1884;1801;3229;456;3685;3668
1718451;TO;Pugmil;1989;1254;1112;2001;365;2366;2746
1718501;TO;Recursolândia;3138;2008;1760;1990;1778;3768;4389
1718550;TO;Riachinho;3670;2166;2017;1810;2373;4183;4723
1718659;TO;Rio da Conceição;1189;887;827;1574;140;1714;2211
1718709;TO;Rio dos Bois;2269;1361;1209;1029;1541;2570;2879
1718758;TO;Rio Sono;6089;3387;2872;2404;3855;6259;6498
1718808;TO;Sampaio;2801;1972;1896;3517;351;3868;4876
1718840;TO;Sandolândia;3332;1741;1585;1764;1562;3326;3371
1718865;TO;Santa Fé do Araguaia;5507;3417;3182;4374;2225;6599;7678
1718881;TO;Santa Maria do Tocantins;2226;1518;1376;1725;1169;2894;3537
1718899;TO;Santa Rita do Tocantins;1852;1109;1019;918;1210;2128;2407
1718907;TO;Santa Rosa do Tocantins;4316;2412;2156;2947;1621;4568;4864
1719004;TO;Santa Tereza do Tocantins;2114;1339;1184;1616;907;2523;2928
1720002;TO;Santa Terezinha do Tocantins;2455;1267;1204;1591;880;2471;2530
1720101;TO;São Bento do Tocantins;3738;2406;2209;2716;1899;4615;5457
1720150;TO;São Félix do Tocantins;1269;773;672;931;514;1445;1610
1720200;TO;São Miguel do Tocantins;8486;5295;5195;2547;7943;10490;12445
1720259;TO;São Salvador do Tocantins;2740;1486;1424;1588;1322;2910;3106
1720309;TO;São Sebastião do Tocantins;3669;2199;2084;3283;1000;4283;4898
1720499;TO;São Valério;5054;2267;2117;2724;1660;4384;3848
1720655;TO;Silvanópolis;4725;2656;2415;4064;1007;5071;5452
1720804;TO;Sítio Novo do Tocantins;9488;4631;4517;4875;4273;9148;8965
1720853;TO;Sucupira;1476;893;846;1106;633;1739;2007
1720903;TO;Taguatinga;13169;7885;7168;10629;4424;15053;16966
1720937;TO;Taipas do Tocantins;1713;1017;928;1557;388;1945;2183
1720978;TO;Talismã;2306;1352;1210;1363;1199;2562;2831
1721000;TO;Palmas;137355;112814;115483;221727;6570;228297;313349
1721109;TO;Tocantínia;5788;3399;3199;2955;3643;6598;7688
1721208;TO;Tocantinópolis;22777;11195;11413;18313;4295;22608;22820
1721257;TO;Tupirama;1179;843;731;930;644;1574;1952
1721307;TO;Tupiratins;1365;1089;1008;1066;1031;2097;2785
1722081;TO;Wanderlândia;10273;5645;5333;5862;5116;10978;11783
1722107;TO;Xambioá;12137;5907;5577;9738;1746;11484;11500
2100055;MA;Açailândia;88320;52093;51920;78241;25772;104013;113783
2100105;MA;Afonso Cunha;4680;3001;2956;3272;2685;5957;6631
2100154;MA;Água Doce do Maranhão;9703;6026;5564;3124;8466;11590;12731
2100204;MA;Alcântara;21291;11251;10601;6400;15452;21852;22126
2100303;MA;Aldeias Altas;18827;12393;11559;13634;10318;23952;26979
2100402;MA;Altamira do Maranhão;8865;5190;5021;3141;7070;10211;8250
2100436;MA;Alto Alegre do Maranhão;20162;12272;12324;19374;5222;24596;28066
2100477;MA;Alto Alegre do Pindaré;30177;15995;15033;9834;21194;31028;31967
2100501;MA;Alto Parnaíba;10174;5468;5297;7028;3737;10765;11233
2100550;MA;Amapá do Maranhão;5431;3311;3120;4841;1590;6431;7047
2100600;MA;Amarante do Maranhão;31292;19760;18134;15006;22888;37894;42017
2100709;MA;Anajatuba;22978;12960;12334;7018;18276;25294;27170
2100808;MA;Anapurus;10280;6984;6939;7158;6765;13923;16054
2100832;MA;Apicum-Açu;11099;7816;7143;9162;5797;14959;17582
2100873;MA;Araguanã;9123;7110;6847;5376;8581;13957;15675
2100907;MA;Araioses;34906;22019;20581;12088;30512;42600;47095
2100956;MA;Arame;29843;16393;15175;12558;19010;31568;32825
2101004;MA;Arari;26366;14308;14169;17484;10993;28477;30014
2101103;MA;Axixá;10142;5831;5594;4705;6720;11425;12234
2101202;MA;Bacabal;91823;47747;52213;77836;22124;99960;105094
2101251;MA;Bacabeira;10516;7542;7423;3324;11641;14965;17446
2101301;MA;Bacuri;15531;8494;8132;8692;7934;16626;18726
2101350;MA;Bacurituba;4671;2743;2561;1429;3875;5304;5696
2101400;MA;Balsas;60163;41568;41969;72786;10751;83537;96951
2101509;MA;Barão de Grajaú;15349;8924;8892;10308;7508;17816;19026
2101608;MA;Barra do Corda;78147;41580;41112;51572;31120;82692;88895
2101707;MA;Barreirinhas;39669;28159;26832;22156;32835;54991;63891
2101731;MA;Belágua;5253;3425;3102;3266;3261;6527;7586
2101772;MA;Bela Vista do Maranhão;9900;6034;5912;5167;6779;11946;11347
2101806;MA;Benedito Leite;5288;2858;2615;2817;2656;5473;5643
2101905;MA;Bequimão;19700;10344;9995;6591;13748;20339;21317
2101939;MA;Bernardo do Mearim;5239;2973;3023;2324;3672;5996;6102
2101970;MA;Boa Vista do Gurupi;5128;4041;3908;5619;2330;7949;8494
2102002;MA;Bom Jardim;34474;19891;19202;16439;22654;39093;42010
2102036;MA;Bom Jesus das Selvas;16545;14872;13584;13431;15025;28456;35095
2102077;MA;Bom Lugar;11534;7555;7268;4181;10642;14823;16578
2102101;MA;Brejo;27513;16858;16456;12312;21002;33314;36900
2102150;MA;Brejo de Areia;10418;5460;5080;2853;7687;10540;8841
2102200;MA;Buriti;24126;13714;13328;8417;18625;27042;28916
2102309;MA;Buriti Bravo;21446;11303;11583;17004;5882;22886;23993
2102325;MA;Buriticupu;51059;33305;31921;35790;29436;65226;73595
2102358;MA;Buritirana;13822;7530;7240;4152;10618;14770;15503
2102374;MA;Cachoeira Grande;7383;4402;4040;3793;4649;8442;9524
2102408;MA;Cajapió;9622;5363;5269;3905;6727;10632;11255
2102507;MA;Cajari;13405;9517;8831;4285;14063;18348;19521
2102556;MA;Campestre do Maranhão;11521;6819;6550;10621;2748;13369;14530
2102606;MA;Cândido Mendes;16566;9690;8815;11911;6594;18505;20376
2102705;MA;Cantanhede;17713;10257;10200;12965;7492;20457;22236
2102754;MA;Capinzal do Norte;10543;5345;5353;5610;5088;10698;10937
2102804;MA;Carolina;23991;12289;11690;16240;7739;23979;24151
2102903;MA;Carutapera;18624;11339;10669;16224;5784;22008;24095
2103000;MA;Caxias;139756;75111;80091;118559;36643;155202;166159
2103109;MA;Cedral;9793;5395;4905;2400;7900;10300;10711
2103125;MA;Central do Maranhão;7186;4137;3851;4175;3813;7988;8806
2103158;MA;Centro do Guilherme;6152;6610;5907;7037;5480;12517;13876
2103174;MA;Centro Novo do Maranhão;14554;9331;8291;5522;12100;17622;22056
2103208;MA;Chapadinha;61322;36230;37051;52814;20467;73281;80705
2103257;MA;Cidelândia;11816;6976;6617;5997;7596;13593;14855
2103307;MA;Codó;111146;57432;60640;81043;37029;118072;123368
2103406;MA;Coelho Neto;42214;23004;23788;38770;8022;46792;49804
2103505;MA;Colinas;35803;19399;19768;25596;13571;39167;41443
2103554;MA;Conceição do Lago-Açu;10774;7482;6946;6860;7568;14428;16559
2103604;MA;Coroatá;55676;30636;31017;43017;18636;61653;65788
2103703;MA;Cururupu;33747;16566;16028;22216;10378;32594;32559
2103752;MA;Davinópolis;12275;6252;6299;10475;2076;12551;12923
2103802;MA;Dom Pedro;21956;10960;11713;15257;7416;22673;23393
2103901;MA;Duque Bacelar;9413;5367;5267;5318;5316;10634;11451
2104008;MA;Esperantinópolis;21224;9077;9379;10039;8417;18456;16971
2104057;MA;Estreito;22930;18927;16811;25676;10062;35738;43097
2104073;MA;Feira Nova do Maranhão;7543;4265;3855;1927;6193;8120;8506
2104081;MA;Fernando Falcão;4823;4806;4374;1511;7669;9180;10559
2104099;MA;Formosa da Serra Negra;13781;9333;8447;5915;11865;17780;19425
2104107;MA;Fortaleza dos Nogueiras;11301;5968;5676;7019;4625;11644;12662
2104206;MA;Fortuna;14596;7618;7490;9504;5604;15108;17812
2104305;MA;Godofredo Viana;6994;5566;5069;6723;3912;10635;12104
2104404;MA;Gonçalves Dias;16790;8676;8809;7778;9707;17485;17953
2104503;MA;Governador Archer;9100;5066;5139;6630;3575;10205;10931
2104552;MA;Governador Edison Lobão;10891;8156;7739;6954;8941;15895;18740
2104602;MA;Governador Eugênio Barros;14629;8057;7926;4690;11293;15983;14703
2104628;MA;Governador Luiz Rocha;6513;3750;3587;5187;2150;7337;7878
2104651;MA;Governador Newton Bello;11804;6017;5905;4291;7631;11922;10121
2104677;MA;Governador Nunes Freire;25921;12863;12539;15945;9457;25402;25502
2104701;MA;Graça Aranha;6080;3031;3109;2912;3228;6140;6261
2104800;MA;Grajaú;47155;31605;30298;36983;24920;61903;70692
2104909;MA;Guimarães;12641;6146;5959;6929;5176;12105;11966
2105005;MA;Humberto de Campos;21266;13687;12510;10505;15692;26197;29143
2105104;MA;Icatu;21489;13093;12054;7813;17334;25147;27423
2105153;MA;Igarapé do Meio;9842;6331;6212;6203;6340;12543;14470
2105203;MA;Igarapé Grande;9759;5428;5619;6670;4377;11047;11453
2105302;MA;Imperatriz;230566;119230;128323;234671;12882;247553;259980
2105351;MA;Itaipava do Grajaú;13341;7382;6882;4243;10021;14264;16158
2105401;MA;Itapecuru Mirim;42772;31030;31093;34717;27406;62123;69233
2105427;MA;Itinga do Maranhão;23128;12580;12311;17660;7231;24891;26134
2105450;MA;Jatobá;5055;4303;4223;3740;4786;8526;10464
2105476;MA;Jenipapo dos Vieiras;10119;7959;7438;2536;12861;15397;17123
2105500;MA;João Lisboa;24598;9976;10405;15346;5035;20381;23677
2105609;MA;Joselândia;14609;7818;7619;5960;9477;15437;16228
2105658;MA;Junco do Maranhão;5533;2007;2013;2819;1201;4020;4334
2105708;MA;Lago da Pedra;40405;22983;23125;30109;15999;46108;50959
2105807;MA;Lago do Junco;9833;5417;5319;3924;6812;10736;10900
2105906;MA;Lago Verde;13038;7730;7677;5053;10354;15407;16369
2105922;MA;Lagoa do Mato;9446;5623;5331;4469;6485;10954;11280
2105948;MA;Lago dos Rodrigues;8443;3867;3932;4850;2949;7799;8841
2105963;MA;Lagoa Grande do Maranhão;8469;5553;4983;5497;5039;10536;11534
2105989;MA;Lajeado Novo;5717;3624;3299;3194;3729;6923;7653
2106003;MA;Lima Campos;10749;5608;5807;6785;4630;11415;11943
2106102;MA;Loreto;10024;5858;5516;6344;5030;11374;12271
2106201;MA;Luís Domingues;5724;3399;3111;5503;1007;6510;7016
2106300;MA;Magalhães de Almeida;13021;8992;8641;8920;8713;17633;20228
2106326;MA;Maracaçumé;14866;9586;9556;15825;3317;19142;21773
2106359;MA;Marajá do Sena;7161;4381;3664;1155;6890;8045;7757
2106375;MA;Maranhãozinho;8445;7168;6898;9020;5046;14066;16754
2106409;MA;Mata Roma;11799;7566;7557;7120;8003;15123;17122
2106508;MA;Matinha;19231;11020;10812;8838;12994;21832;23591
2106607;MA;Matões;26433;15534;15396;13623;17307;30930;34099
2106631;MA;Matões do Norte;7435;7242;6554;4679;9117;13796;17316
2106672;MA;Milagres do Maranhão;5149;4197;3921;1760;6358;8118;8502
2106706;MA;Mirador;19906;10446;9988;9366;11068;20434;21045
2106755;MA;Miranda do Norte;16123;11759;12572;19423;4908;24331;29121
2106805;MA;Mirinzal;13005;7286;6927;9031;5182;14213;15059
2106904;MA;Monção;26043;16185;15563;11753;19995;31748;33888
2107001;MA;Montes Altos;10347;4910;4514;5135;4289;9424;9064
2107100;MA;Morros;14594;9156;8649;6733;11072;17805;19708
2107209;MA;Nina Rodrigues;8289;6338;6129;4432;8035;12467;14826
2107258;MA;Nova Colinas;3904;2600;2285;2210;2675;4885;5469
2107308;MA;Nova Iorque;4543;2336;2264;2877;1723;4600;4682
2107357;MA;Nova Olinda do Maranhão;15660;9539;9586;11843;7282;19125;21228
2107407;MA;Olho dÁgua das Cunhãs;14377;9154;9351;9555;8950;18505;19616
2107456;MA;Olinda Nova do Maranhão;10128;6780;6342;5943;7179;13122;14968
2107506;MA;Paço do Lumiar;76188;50744;54137;78749;26132;104881;125265
2107605;MA;Palmeirândia;17264;9388;9378;3461;15305;18766;19840
2107704;MA;Paraibano;17854;9875;10229;15747;4357;20104;21571
2107803;MA;Parnarama;32469;17541;17072;13530;21083;34613;35108
2107902;MA;Passagem Franca;14817;8702;8874;10473;7103;17576;19253
2108009;MA;Pastos Bons;15460;9168;8911;12308;5771;18079;19693
2108058;MA;Paulino Neves;11526;7486;7012;4651;9847;14498;16295
2108108;MA;Paulo Ramos;19290;10137;9950;10836;9251;20087;21092
2108207;MA;Pedreiras;39828;18889;20592;32965;6516;39481;39153
2108256;MA;Pedro do Rosário;17954;11830;10901;5893;16838;22731;25560
2108306;MA;Penalva;30299;17397;16849;16575;17671;34246;38987
2108405;MA;Peri Mirim;13071;6993;6814;3668;10139;13807;14371
2108454;MA;Peritoró;17336;10119;10155;6827;13447;20274;23530
2108504;MA;Pindaré-Mirim;27517;15220;15925;22402;8743;31145;33186
2108603;MA;Pinheiro;68030;38066;40081;46458;31689;78147;84160
2108702;MA;Pio XII;28413;11004;11012;12459;9557;22016;21274
2108801;MA;Pirapemas;15124;8656;8702;11114;6244;17358;18814
2108900;MA;Poção de Pedras;22378;9914;9791;8377;11328;19705;17321
2109007;MA;Porto Franco;16840;10832;10674;16865;4641;21506;24294
2109056;MA;Porto Rico do Maranhão;6380;3211;2851;2432;3630;6062;5936
2109106;MA;Presidente Dutra;39541;21966;22753;31997;12722;44719;48264
2109205;MA;Presidente Juscelino;10693;6006;5531;4120;7417;11537;12939
2109239;MA;Presidente Médici;5116;3293;3077;3904;2466;6370;7124
2109270;MA;Presidente Sarney;13718;8881;8262;4286;12857;17143;19217
2109304;MA;Presidente Vargas;10483;5467;5262;4588;6141;10729;11328
2109403;MA;Primeira Cruz;11019;7382;6514;4294;9602;13896;15545
2109452;MA;Raposa;17088;13129;13151;16642;9638;26280;31586
2109502;MA;Riachão;20983;10392;9826;10210;10008;20218;20288
2109551;MA;Ribamar Fiquene;6488;3759;3535;3662;3632;7294;7859
2109601;MA;Rosário;33665;19660;19922;23258;16324;39582;43243
2109700;MA;Sambaíba;5261;2891;2593;2836;2648;5484;5686
2109759;MA;Santa Filomena do Maranhão;4667;3671;3392;2293;4770;7063;7878
2109809;MA;Santa Helena;30860;19383;19677;19583;19477;39060;42829
2109908;MA;Santa Inês;68321;37303;40879;73932;4250;78182;89927
2110005;MA;Santa Luzia;69271;35320;34072;25862;43530;69392;73105
2110039;MA;Santa Luzia do Paruá;20058;11377;11267;12591;10053;22644;25487
2110104;MA;Santa Quitéria do Maranhão;28150;14716;14456;14139;15033;29172;25884
2110203;MA;Santa Rita;24922;16324;16041;14898;17467;32365;38732
2110237;MA;Santana do Maranhão;10944;6028;5633;1842;9819;11661;13704
2110278;MA;Santo Amaro do Maranhão;9612;7309;6512;3610;10211;13821;16219
2110302;MA;Santo Antônio dos Lopes;14253;7190;7098;5732;8556;14288;14516
2110401;MA;São Benedito do Rio Preto;16442;9042;8760;11049;6753;17802;18769
2110500;MA;São Bento;31819;19933;20784;23496;17221;40717;45989
2110609;MA;São Bernardo;22720;13366;13114;11800;14680;26480;28825
2110658;MA;São Domingos do Azeitão;6289;3566;3417;4961;2022;6983;7448
2110708;MA;São Domingos do Maranhão;33049;16900;16730;17320;16310;33630;34391
2110807;MA;São Félix de Balsas;5144;2445;2243;1627;3061;4688;4540
2110856;MA;São Francisco do Brejão;7062;5255;4971;4809;5417;10226;12082
2110906;MA;São Francisco do Maranhão;12854;6164;5999;4117;8046;12163;12226
2111003;MA;São João Batista;18917;10164;9802;5357;14609;19966;20736
2111029;MA;São João do Carú;13495;6343;5972;6329;5986;12315;15768
2111052;MA;São João do Paraíso;10365;5778;5045;5278;5545;10823;11207
2111078;MA;São João do Soter;14834;8754;8350;6614;10490;17104;18746
2111102;MA;São João dos Patos;23182;12180;12733;20553;4360;24913;26063
2111201;MA;São José de Ribamar;107384;78626;84299;37713;125212;162925;180345
2111250;MA;São José dos Basílios;7432;3760;3736;3006;4490;7496;7639
2111300;MA;São Luís;870028;473762;538181;955600;56343;1011943;1115932
2111409;MA;São Luís Gonzaga do Maranhão;22772;10161;9995;7896;12260;20156;18600
2111508;MA;São Mateus do Maranhão;34859;19241;19868;28724;10385;39109;41750
2111532;MA;São Pedro da Água Branca;10927;6117;5908;10707;1318;12025;12779
2111573;MA;São Pedro dos Crentes;4024;2360;2068;2437;1991;4428;4700
2111607;MA;São Raimundo das Mangabeiras;14870;8888;8592;12540;4940;17480;19090
2111631;MA;São Raimundo do Doca Bezerra;6671;3186;2904;1731;4359;6090;5028
2111672;MA;São Roberto;4400;3091;2866;2845;3112;5957;6856
2111706;MA;São Vicente Ferrer;18406;10586;10284;5445;15425;20870;22452
2111722;MA;Satubinha;10815;6164;5823;3634;8353;11987;14274
2111748;MA;Senador Alexandre Costa;8571;5123;5130;6160;4093;10253;11285
2111763;MA;Senador La Rocque;16242;9069;8941;8733;9277;18010;13981
2111789;MA;Serrano do Maranhão;9120;5843;5081;4222;6702;10924;10343
2111805;MA;Sítio Novo;15114;8949;8058;5137;11870;17007;18237
2111904;MA;Sucupira do Norte;10378;5328;5103;4945;5486;10431;10631
2111953;MA;Sucupira do Riachão;4287;2371;2239;2862;1748;4610;5692
2112001;MA;Tasso Fragoso;6393;3972;3824;4648;3148;7796;8642
2112100;MA;Timbiras;26401;14100;13907;17471;10536;28007;29241
2112209;MA;Timon;129692;75465;79931;135119;20277;155396;171317
2112233;MA;Trizidela do Vale;16402;9140;9811;16168;2783;18951;22223
2112274;MA;Tufilândia;5527;2862;2745;2746;2861;5607;5868
2112308;MA;Tuntum;35411;20025;19232;17911;21346;39257;42242
2112407;MA;Turiaçu;31289;17634;16322;10922;23034;33956;35811
2112456;MA;Turilândia;17231;11481;11369;10353;12497;22850;26112
2112506;MA;Tutóia;37728;26675;26036;18717;33994;52711;59927
2112605;MA;Urbano Santos;17603;12353;12195;17358;7190;24548;33791
2112704;MA;Vargem Grande;34707;24625;24790;26687;22728;49415;57813
2112803;MA;Viana;44190;24694;24758;26902;22550;49452;52852
2112852;MA;Vila Nova dos Martírios;6705;5930;5328;6187;5071;11258;13800
2112902;MA;Vitória do Mearim;29953;15565;15669;14818;16416;31234;32956
2113009;MA;Vitorino Freire;27462;15716;15938;16164;15490;31654;31520
2114007;MA;Zé Doca;46134;24891;25269;30856;19304;50160;52190
2200053;PI;Acauã;5147;3459;3290;901;5848;6749;7119
2200103;PI;Agricolândia;5340;2467;2647;3617;1497;5114;5123
2200202;PI;Água Branca;14517;7813;8648;14549;1912;16461;17525
2200251;PI;Alagoinha do Piauí;6868;3687;3662;2669;4680;7349;7678
2200277;PI;Alegrete do Piauí;4713;2556;2595;2837;2314;5151;4921
2200301;PI;Alto Longá;12000;6966;6688;6714;6940;13654;14371
2200400;PI;Altos;39122;19114;19709;27391;11432;38823;40681
2200459;PI;Alvorada do Gurguéia;4211;2651;2400;1849;3202;5051;5469
2200509;PI;Amarante;16884;8331;8810;8775;8366;17141;17609
2200608;PI;Angical do Piauí;6788;3233;3437;5212;1458;6670;6779
2200707;PI;Anísio de Abreu;7166;4641;4453;4504;4590;9094;9994
2200806;PI;Antônio Almeida;2851;1562;1484;2227;819;3046;3175
2200905;PI;Aroazes;6025;2866;2915;3432;2349;5781;5819
2200954;PI;Aroeiras do Itaim;0;1274;1168;238;2204;2442;2551
2201002;PI;Arraial;4909;2316;2372;2433;2255;4688;4713
2201051;PI;Assunção do Piauí;6933;3825;3678;3378;4125;7503;7879
2201101;PI;Avelino Lopes;9625;5581;5486;6714;4353;11067;11361
2201150;PI;Baixa Grande do Ribeiro;7779;5466;5050;6487;4029;10516;11751
2201176;PI;Barra DAlcântara;4107;1821;2031;2032;1820;3852;3953
2201200;PI;Barras;40891;22562;22288;22126;22724;44850;47298
2201309;PI;Barreiras do Piauí;3098;1690;1544;1875;1359;3234;3356
2201408;PI;Barro Duro;6787;3231;3378;4789;1820;6609;7022
2201507;PI;Batalha;24127;13055;12731;9619;16167;25786;26951
2201556;PI;Bela Vista do Piauí;2963;1936;1842;1243;2535;3778;4044
2201572;PI;Belém do Piauí;2429;1682;1602;1603;1681;3284;3607
2201606;PI;Beneditinos;9712;5014;4897;6261;3650;9911;10479
2201705;PI;Bertolínia;5117;2679;2640;3894;1425;5319;5512
2201739;PI;Betânia do Piauí;8640;3114;2901;1678;4337;6015;6214
2201770;PI;Boa Hora;5170;3204;3095;1524;4775;6299;6848
2201804;PI;Bocaina;4208;2135;2211;1730;2616;4346;4509
2201903;PI;Bom Jesus;15924;11306;11326;17627;5005;22632;25584
2201919;PI;Bom Princípio do Piauí;4625;2747;2557;1654;3650;5304;5670
2201929;PI;Bonfim do Piauí;4881;2695;2698;1635;3758;5393;5700
2201945;PI;Boqueirão do Piauí;5567;3080;3113;2666;3527;6193;6443
2201960;PI;Brasileira;7366;4073;3888;3478;4483;7961;8364
2201988;PI;Brejo do Piauí;3986;1946;1906;1426;2426;3852;3824
2202000;PI;Buriti dos Lopes;18598;9623;9451;10294;8780;19074;19832
2202026;PI;Buriti dos Montes;7284;4143;3834;2421;5556;7977;8282
2202059;PI;Cabeceiras do Piauí;8498;5095;4832;1657;8270;9927;10671
2202075;PI;Cajazeiras do Piauí;2667;1699;1644;1112;2231;3343;3586
2202083;PI;Cajueiro da Praia;6122;3742;3421;2699;4464;7163;7704
2202091;PI;Caldeirão Grande do Piauí;5481;2839;2829;1660;4008;5668;5786
2202109;PI;Campinas do Piauí;5141;2713;2693;1805;3601;5406;5628
2202117;PI;Campo Alegre do Fidalgo;4451;2405;2291;1224;3472;4696;5093
2202133;PI;Campo Grande do Piauí;4882;2840;2752;1569;4023;5592;5987
2202174;PI;Campo Largo do Piauí;5743;3466;3337;1430;5373;6803;7342
2202208;PI;Campo Maior;43126;21781;23399;33524;11656;45180;46950
2202251;PI;Canavieira;4114;2028;1894;1741;2181;3922;3938
2202307;PI;Canto do Buriti;18371;9960;10075;11140;8895;20035;21326
2202406;PI;Capitão de Campos;10036;5440;5516;6347;4609;10956;11471
2202455;PI;Capitão Gervásio Oliveira;3433;1997;1879;1162;2714;3876;4127
2202505;PI;Caracol;8040;5203;5009;4028;6184;10212;11009
2202539;PI;Caraúbas do Piauí;4809;2837;2685;967;4555;5522;5910
2202554;PI;Caridade do Piauí;4062;2501;2324;1579;3246;4825;5102
2202604;PI;Castelo do Piauí;18339;8984;9354;11479;6859;18338;19716
2202653;PI;Caxingó;4147;2656;2383;966;4073;5039;5477
2202703;PI;Cocal;24150;13178;12866;12021;14023;26044;27901
2202711;PI;Cocal de Telha;4248;2209;2316;2667;1858;4525;4908
2202729;PI;Cocal dos Alves;5155;2797;2775;1782;3790;5572;6180
2202737;PI;Coivaras;3507;1970;1841;1173;2638;3811;4044
2202752;PI;Colônia do Gurguéia;5012;2967;3068;4851;1184;6035;6545
2202778;PI;Colônia do Piauí;7251;3701;3732;2644;4789;7433;7665
2202802;PI;Conceição do Canindé;4926;2251;2233;2365;2119;4484;4811
2202851;PI;Coronel José Dias;4415;2379;2162;1491;3050;4541;4688
2202901;PI;Corrente;23226;12843;12565;15693;9715;25408;26771
2203008;PI;Cristalândia do Piauí;6493;4087;3744;2945;4886;7831;8350
2203107;PI;Cristino Castro;9269;5041;4940;7261;2720;9981;10464
2203206;PI;Curimatá;9518;5457;5308;7084;3681;10765;11461
2203230;PI;Currais;4232;2473;2231;924;3780;4704;4982
2203255;PI;Curralinhos;3641;2144;2038;1331;2851;4182;4475
2203271;PI;Curral Novo do Piauí;4220;2534;2336;1372;3498;4870;5390
2203305;PI;Demerval Lobão;12489;6472;6802;10873;2401;13274;13862
2203354;PI;Dirceu Arcoverde;6066;3406;3271;2371;4306;6677;7046
2203404;PI;Dom Expedito Lopes;5954;3229;3358;3594;2993;6587;6940
2203420;PI;Domingos Mourão;4284;2157;2107;958;3306;4264;4352
2203453;PI;Dom Inocêncio;8909;4732;4514;2018;7228;9246;9574
2203503;PI;Elesbão Veloso;15002;7141;7358;10119;4380;14499;14550
2203602;PI;Eliseu Martins;4188;2403;2264;3823;844;4667;4943
2203701;PI;Esperantina;34094;18772;18993;23156;14609;37765;39953
2203750;PI;Fartura do Piauí;4685;2574;2502;1336;3740;5076;5330
2203800;PI;Flores do Piauí;4372;2220;2148;1987;2381;4368;4461
2203859;PI;Floresta do Piauí;2416;1272;1210;861;1621;2482;2561
2203909;PI;Floriano;54591;27318;30389;49978;7729;57707;60111
2204006;PI;Francinópolis;5254;2556;2674;3271;1959;5230;5345
2204105;PI;Francisco Ayres;5236;2224;2259;2154;2329;4483;4300
2204154;PI;Francisco Macedo;2337;1436;1443;1159;1720;2879;3216
2204204;PI;Francisco Santos;7043;4393;4226;3989;4630;8619;9423
2204303;PI;Fronteiras;10012;5482;5640;7294;3828;11122;11690
2204352;PI;Geminiano;4790;2776;2699;1216;4259;5475;5477
2204402;PI;Gilbués;10229;5216;5177;5991;4402;10393;10698
2204501;PI;Guadalupe;10308;5088;5180;9842;426;10268;10496
2204550;PI;Guaribas;4814;2216;2185;1275;3126;4401;4573
2204600;PI;Hugo Napoleão;3703;1839;1932;3098;673;3771;3880
2204659;PI;Ilha Grande;7890;4557;4357;7445;1469;8914;9487
2204709;PI;Inhuma;14426;7333;7535;7294;7574;14868;15330
2204808;PI;Ipiranga do Piauí;8428;4600;4726;5745;3581;9326;9863
2204907;PI;Isaías Coelho;7658;4112;4106;1843;6375;8218;8582
2205003;PI;Itainópolis;10381;5546;5553;2517;8582;11099;11571
2205102;PI;Itaueira;10347;5383;5294;5942;4735;10677;11037
2205151;PI;Jacobina do Piauí;5690;2903;2816;1026;4693;5719;5718
2205201;PI;Jaicós;15859;8784;9224;8544;9464;18008;19233
2205250;PI;Jardim do Mulato;3990;2182;2127;1183;3126;4309;4522
2205276;PI;Jatobá do Piauí;4314;2412;2225;888;3749;4637;4885
2205300;PI;Jerumenha;4515;2216;2167;2469;1914;4383;4443
2205359;PI;João Costa;3025;1571;1389;701;2259;2960;3003
2205409;PI;Joaquim Pires;13076;7155;6667;4260;9562;13822;14396
2205458;PI;Joca Marques;4349;2665;2435;1677;3423;5100;5488
2205508;PI;José de Freitas;32858;18524;18571;21604;15491;37095;39457
2205516;PI;Juazeiro do Piauí;4523;2419;2338;1479;3278;4757;5491
2205524;PI;Júlio Borges;4866;2802;2575;1618;3759;5377;5653
2205532;PI;Jurema;4047;2356;2161;866;3651;4517;4790
2205540;PI;Lagoinha do Piauí;2231;1339;1317;1582;1074;2656;2870
2205557;PI;Lagoa Alegre;6849;4128;3880;3042;4966;8008;8610
2205565;PI;Lagoa do Barro do Piauí;4450;2321;2202;994;3529;4523;4658
2205573;PI;Lagoa de São Francisco;5795;3208;3214;2092;4330;6422;6795
2205581;PI;Lagoa do Piauí;3488;1990;1873;1672;2191;3863;4086
2205599;PI;Lagoa do Sítio;4138;2472;2381;1723;3130;4853;5219
2205607;PI;Landri Sales;5628;2619;2662;3957;1324;5281;5272
2205706;PI;Luís Correia;24253;14605;13817;12646;15776;28422;30558
2205805;PI;Luzilândia;24042;12401;12310;13252;11459;24711;25521
2205854;PI;Madeiro;6771;4044;3772;3364;4452;7816;8372
2205904;PI;Manoel Emídio;5151;2700;2509;3315;1894;5209;5352
2205953;PI;Marcolândia;6178;3864;3946;6705;1105;7810;8590
2206001;PI;Marcos Parente;4279;2219;2237;3845;611;4456;4546
2206050;PI;Massapê do Piauí;5988;3154;3068;936;5286;6222;6456
2206100;PI;Matias Olímpio;9727;5274;5211;4808;5677;10485;10979
2206209;PI;Miguel Alves;29849;16360;15932;10714;21578;32292;33901
2206308;PI;Miguel Leão;1370;657;596;862;391;1253;1239
2206357;PI;Milton Brandão;6900;3442;3328;1702;5068;6770;6603
2206407;PI;Monsenhor Gil;10309;5112;5225;5316;5021;10337;10563
2206506;PI;Monsenhor Hipólito;6764;3715;3676;3485;3906;7391;7785
2206605;PI;Monte Alegre do Piauí;10230;5288;5061;2981;7368;10349;10618
2206654;PI;Morro Cabeça no Tempo;4426;2061;2007;1404;2664;4068;4527
2206670;PI;Morro do Chapéu do Piauí;6006;3323;3176;2298;4201;6499;6825
2206696;PI;Murici dos Portelas;6375;4422;4042;1689;6775;8464;9258
2206704;PI;Nazaré do Piauí;7805;3674;3653;3503;3824;7327;7307
2206720;PI;Nazária;0;4075;3964;1652;6387;8039;8632
2206753;PI;Nossa Senhora de Nazaré;3865;2333;2227;1363;3197;4560;4911
2206803;PI;Nossa Senhora dos Remédios;7214;4083;4131;3693;4521;8214;8751
2206902;PI;Novo Oriente do Piauí;6760;3234;3264;3280;3218;6498;6548
2206951;PI;Novo Santo Antônio;3155;1672;1588;916;2344;3260;3014
2207009;PI;Oeiras;33910;17045;18601;22001;13645;35646;37138
2207108;PI;Olho DÁgua do Piauí;2283;1310;1320;1064;1566;2630;2477
2207207;PI;Padre Marcos;7178;3219;3432;2355;4296;6651;6879
2207306;PI;Paes Landim;4184;2048;2011;2376;1683;4059;4124
2207355;PI;Pajeú do Piauí;2894;1745;1621;1426;1940;3366;3416
2207405;PI;Palmeira do Piauí;5199;2571;2422;1764;3229;4993;5029
2207504;PI;Palmeirais;12154;6781;6964;5342;8403;13745;14633
2207553;PI;Paquetá;4386;2148;1999;557;3590;4147;3931
2207603;PI;Parnaguá;9345;5451;4814;5328;4937;10265;10846
2207702;PI;Parnaíba;132282;69729;76000;137507;8222;145729;153863
2207751;PI;Passagem Franca do Piauí;4195;2316;2230;2482;2064;4546;4331
2207777;PI;Patos do Piauí;5634;3094;3012;1689;4417;6106;6420
2207793;PI;Pau DArco do Piauí;0;1935;1822;556;3201;3757;4084
2207801;PI;Paulistana;16529;9566;10217;10654;9129;19783;20583
2207850;PI;Pavussu;3973;1953;1713;1793;1873;3666;3662
2207900;PI;Pedro II;36201;18443;19057;22671;14829;37500;38812
2207934;PI;Pedro Laurentino;2002;1251;1159;819;1591;2410;2551
2207959;PI;Nova Santa Rita;4150;2158;2034;704;3488;4192;4392
2208007;PI;Picos;68974;35069;38348;58295;15122;73417;78627
2208106;PI;Pimenteiras;11306;5980;5733;4795;6918;11713;12150
2208205;PI;Pio IX;16505;8837;8856;5290;12403;17693;18492
2208304;PI;Piracuruca;24786;13623;13925;19242;8306;27548;28952
2208403;PI;Piripiri;60154;30141;31699;44539;17301;61840;63829
2208502;PI;Porto;10573;6009;5888;7503;4394;11897;12646
2208551;PI;Porto Alegre do Piauí;2421;1324;1235;1802;757;2559;2728
2208601;PI;Prata do Piauí;3117;1551;1534;2552;533;3085;3149
2208650;PI;Queimada Nova;8332;4289;4276;1156;7409;8565;9041
2208700;PI;Redenção do Gurguéia;7781;4224;4179;5334;3069;8403;8814
2208809;PI;Regeneração;17471;8599;8977;13832;3744;17576;17979
2208858;PI;Riacho Frio;4321;2221;2017;2222;2016;4238;4306
2208874;PI;Ribeira do Piauí;3879;2138;2125;1030;3233;4263;4499
2208908;PI;Ribeiro Gonçalves;5722;3509;3332;4445;2396;6841;7408
2209005;PI;Rio Grande do Piauí;6131;3184;3245;4094;2335;6429;6434
2209104;PI;Santa Cruz do Piauí;5776;2971;3054;4067;1958;6025;6254
2209153;PI;Santa Cruz dos Milagres;3334;1884;1910;2127;1667;3794;4046
2209203;PI;Santa Filomena;6031;3219;2877;3544;2552;6096;6256
2209302;PI;Santa Luz;4780;2869;2644;3109;2404;5513;5903
2209351;PI;Santana do Piauí;4595;2407;2513;1941;2979;4920;4650
2209377;PI;Santa Rosa do Piauí;5223;2582;2567;3655;1494;5149;5254
2209401;PI;Santo Antônio de Lisboa;5154;2979;3029;3917;2091;6008;6466
2209450;PI;Santo Antônio dos Milagres;1876;1023;1035;807;1251;2058;2172
2209500;PI;Santo Inácio do Piauí;3447;1854;1799;2297;1356;3653;3809
2209559;PI;São Braz do Piauí;4192;2243;2070;1021;3292;4313;4454
2209609;PI;São Félix do Piauí;3397;1500;1569;1641;1428;3069;2923
2209658;PI;São Francisco de Assis do Piauí;3806;2837;2738;1429;4146;5575;5801
2209708;PI;São Francisco do Piauí;6356;3191;3110;1983;4318;6301;6417
2209757;PI;São Gonçalo do Gurguéia;2322;1464;1361;1219;1606;2825;3071
2209807;PI;São Gonçalo do Piauí;4249;2351;2403;3308;1446;4754;5044
2209856;PI;São João da Canabrava;4240;2188;2257;1233;3212;4445;4619
2209872;PI;São João da Fronteira;4886;2805;2803;2272;3336;5608;6084
2209906;PI;São João da Serra;6675;3012;3145;3447;2710;6157;6106
2209955;PI;São João da Varjota;4375;2282;2366;1389;3259;4648;4856
2209971;PI;São João do Arraial;5734;3698;3639;3703;3634;7337;8085
2210003;PI;São João do Piauí;17670;9584;9969;13470;6083;19553;20720
2210052;PI;São José do Divino;4881;2649;2492;2703;2438;5141;5361
2210102;PI;São José do Peixe;3825;1886;1814;1889;1811;3700;3737
2210201;PI;São José do Piauí;6706;3287;3321;1935;4673;6608;6696
2210300;PI;São Julião;5700;2831;2846;2328;3349;5677;6379
2210359;PI;São Lourenço do Piauí;4274;2265;2158;1113;3310;4423;4581
2210375;PI;São Luis do Piauí;2488;1262;1299;814;1747;2561;2648
2210383;PI;São Miguel da Baixa Grande;2030;1050;1063;1358;755;2113;2456
2210391;PI;São Miguel do Fidalgo;2991;1546;1430;1085;1891;2976;3037
2210409;PI;São Miguel do Tapuio;18808;9225;8924;6684;11465;18149;17617
2210508;PI;São Pedro do Piauí;12510;6820;6825;8194;5451;13645;14356
2210607;PI;São Raimundo Nonato;26890;15899;16448;21272;11075;32347;35035
2210623;PI;Sebastião Barros;4524;1886;1673;1112;2447;3559;3434
2210631;PI;Sebastião Leal;3835;2151;1965;1922;2194;4116;4311
2210656;PI;Sigefredo Pacheco;9046;4972;4647;3176;6443;9619;10074
2210706;PI;Simões;13621;7079;7106;5697;8488;14185;14664
2210805;PI;Simplício Mendes;10966;6090;5988;7163;4915;12078;12778
2210904;PI;Socorro do Piauí;4675;2296;2232;1630;2898;4528;4557
2210938;PI;Sussuapara;5042;3102;3133;1582;4653;6235;6801
2210953;PI;Tamboril do Piauí;2413;1446;1309;1512;1243;2755;2939
2210979;PI;Tanque do Piauí;2318;1277;1344;1239;1382;2621;2781
2211001;PI;Teresina;715360;380693;433746;767777;46662;814439;871126
2211100;PI;União;39801;21402;21255;20969;21688;42657;44649
2211209;PI;Uruçuí;17011;9916;10236;15503;4649;20152;21746
2211308;PI;Valença do Piauí;19887;9579;10746;15791;4534;20325;20940
2211357;PI;Várzea Branca;5203;2506;2407;1147;3766;4913;4930
2211407;PI;Várzea Grande;4475;2048;2288;2581;1755;4336;4382
2211506;PI;Vera Mendes;2907;1494;1493;967;2020;2987;3082
2211605;PI;Vila Nova do Piauí;2906;1576;1500;759;2317;3076;2935
2211704;PI;Wall Ferraz;3998;2167;2113;1166;3114;4280;4479
2300101;CE;Abaiara;8385;5215;5274;4552;5937;10489;11965
2300150;CE;Acarape;12927;7570;7767;7982;7355;15337;15140
2300200;CE;Acaraú;48968;29093;28449;28237;29305;57542;63556
2300309;CE;Acopiara;47137;25629;25542;25237;25934;51171;54687
2300408;CE;Aiuaba;14452;8119;8088;3955;12252;16207;17584
2300507;CE;Alcântaras;9548;5315;5458;3450;7323;10773;11846
2300606;CE;Altaneira;5687;3313;3538;4952;1899;6851;7712
2300705;CE;Alto Santo;15394;8218;8142;8040;8320;16360;16077
2300754;CE;Amontada;32333;20360;18873;15949;23284;39233;44195
2300804;CE;Antonina do Norte;6509;3344;3640;4999;1985;6984;7402
2300903;CE;Apuiarés;12540;7073;6854;5774;8153;13927;14742
2301000;CE;Aquiraz;60469;37142;35509;67103;5548;72651;81581
2301109;CE;Aracati;61187;34152;35015;44038;25129;69167;75392
2301208;CE;Aracoiaba;24064;12795;12610;13745;11660;25405;26600
2301257;CE;Ararendá;10008;5183;5317;4908;5592;10500;10983
2301307;CE;Araripe;19606;10292;10397;12737;7952;20689;21707
2301406;CE;Aratuba;12359;5823;5706;3769;7760;11529;11759
2301505;CE;Arneiroz;7538;3853;3804;3884;3773;7657;7848
2301604;CE;Assaré;20882;11081;11367;11955;10493;22448;23537
2301703;CE;Aurora;25207;12223;12350;11830;12743;24573;24567
2301802;CE;Baixio;5724;3055;2971;3304;2722;6026;6318
2301851;CE;Banabuiú;16173;8739;8581;8760;8560;17320;18313
2301901;CE;Barbalha;47031;26939;28434;38039;17334;55373;61662
2301950;CE;Barreira;17024;9736;9838;8127;11447;19574;22715
2302008;CE;Barro;20007;10632;10896;13168;8360;21528;22834
2302057;CE;Barroquinha;13921;7319;7156;9771;4704;14475;15069
2302107;CE;Baturité;29861;16402;16924;24446;8880;33326;36127
2302206;CE;Beberibe;42343;24860;24474;21639;27695;49334;54315
2302305;CE;Bela Cruz;28358;15698;15175;12992;17881;30873;32851
2302404;CE;Boa Viagem;50306;26347;26174;26622;25899;52521;54680
2302503;CE;Brejo Santo;38484;21913;23277;28048;17142;45190;50195
2302602;CE;Camocim;55448;29769;30394;44647;15516;60163;64147
2302701;CE;Campos Sales;25566;12707;13803;19085;7425;26510;27513
2302800;CE;Canindé;69601;36920;37566;46878;27608;74486;77484
2302909;CE;Capistrano;15830;8637;8426;6212;10851;17063;17830
2303006;CE;Caridade;15604;10123;9897;11523;8497;20020;23011
2303105;CE;Cariré;18617;9143;9205;8302;10046;18348;18470
2303204;CE;Caririaçu;25733;12795;13592;14044;12343;26387;27008
2303303;CE;Cariús;18444;9334;9233;8310;10257;18567;18700
2303402;CE;Carnaubal;15230;8346;8400;7960;8786;16746;17763
2303501;CE;Cascavel;57129;32874;33250;56143;9981;66124;72706
2303600;CE;Catarina;15547;9302;9443;8728;10017;18745;21041
2303659;CE;Catunda;9286;5034;4917;5395;4556;9951;10410
2303709;CE;Caucaia;250479;159175;165563;289918;34820;324738;368918
2303808;CE;Cedro;24062;12111;12427;15164;9374;24538;25612
2303907;CE;Chaval;12163;6195;6422;9170;3447;12617;13112
2303931;CE;Choró;12001;6585;6268;3794;9059;12853;13608
2303956;CE;Chorozinho;18707;9602;9318;11427;7493;18920;20286
2304004;CE;Coreaú;19981;10981;11037;14258;7760;22018;23340
2304103;CE;Crateús;70898;35527;37326;52688;20165;72853;75241
2304202;CE;Crato;104646;57632;63830;100937;20525;121462;133913
2304236;CE;Croatá;16064;8330;8747;9038;8039;17077;18201
2304251;CE;Cruz;19779;11092;11388;9570;12910;22480;25121
2304269;CE;Deputado Irapuan Pinheiro;8385;4560;4534;4131;4963;9094;9698
2304277;CE;Ererê;6302;3435;3418;3461;3392;6853;7254
2304285;CE;Eusébio;31500;22957;23090;46047;0;46047;55035
2304301;CE;Farias Brito;20315;9329;9678;8871;10136;19007;19330
2304350;CE;Forquilha;17488;10786;11000;15473;6313;21786;24680
2304400;CE;Fortaleza;2141402;1145799;1301610;2447409;0;2447409;2703391
2304459;CE;Fortim;12066;7469;7382;9627;5224;14851;16776
2304509;CE;Frecheirinha;11832;6378;6613;7636;5355;12991;14195
2304608;CE;General Sampaio;4866;3163;3053;3648;2568;6216;7767
2304657;CE;Graça;14813;7441;7611;5818;9234;15052;14415
2304707;CE;Granja;48484;26725;25945;25902;26768;52670;55170
2304806;CE;Granjeiro;5295;2265;2361;1369;3257;4626;4784
2304905;CE;Groaíras;8741;5045;5183;7076;3152;10228;11219
2304954;CE;Guaiúba;19884;12140;11951;18877;5214;24091;26508
2305001;CE;Guaraciaba do Norte;35037;18661;19116;17405;20372;37777;40921
2305100;CE;Guaramiranga;5714;2100;2065;2495;1670;4165;5073
2305209;CE;Hidrolândia;17687;9638;9704;11054;8288;19342;20126
2305233;CE;Horizonte;33790;27519;27635;51016;4138;55154;69688
2305266;CE;Ibaretama;12561;6671;6257;4449;8479;12928;13385
2305308;CE;Ibiapina;22157;11942;11868;10743;13067;23810;25165
2305332;CE;Ibicuitinga;9435;5861;5474;5742;5593;11335;12730
2305357;CE;Icapuí;16052;9414;8979;5779;12614;18393;20183
2305407;CE;Icó;62521;31882;33571;30465;34988;65453;68303
2305506;CE;Iguatu;85615;46438;50085;74654;21869;96523;103633
2305605;CE;Independência;25262;12746;12840;11480;14106;25586;26196
2305654;CE;Ipaporanga;11247;5658;5677;4128;7207;11335;11597
2305704;CE;Ipaumirim;11539;5999;6015;7138;4876;12014;12507
2305803;CE;Ipu;39078;19955;20345;25582;14718;40300;42148
2305902;CE;Ipueiras;38219;18538;19336;18366;19508;37874;38064
2306009;CE;Iracema;13155;6765;6960;9821;3904;13725;14351
2306108;CE;Irauçuba;19560;11353;10994;14366;7981;22347;24450
2306207;CE;Itaiçaba;6579;3644;3677;4282;3039;7321;7904
2306256;CE;Itaitinga;29217;18304;17534;35586;252;35838;38661
2306306;CE;Itapagé;41093;23996;24370;34001;14365;48366;53448
2306405;CE;Itapipoca;94369;58244;57821;66895;49170;116065;131687
2306504;CE;Itapiúna;16276;9461;9165;8819;9807;18626;20653
2306553;CE;Itarema;30347;19345;18117;15937;21525;37462;42595
2306603;CE;Itatira;15541;9588;9306;9522;9372;18894;22018
2306702;CE;Jaguaretama;18024;9074;8793;8470;9397;17867;18133
2306801;CE;Jaguaribara;8730;5281;5124;7218;3187;10405;11580
2306900;CE;Jaguaribe;35062;16824;17592;23278;11138;34416;34592
2307007;CE;Jaguaruana;29735;16078;16161;19139;13100;32239;33960
2307106;CE;Jardim;26414;13076;13621;8998;17699;26697;27187
2307205;CE;Jati;7265;3835;3814;4483;3166;7649;8150
2307254;CE;Jijoca de Jericoacoara;12089;8520;8482;5556;11446;17002;20351
2307304;CE;Juazeiro do Norte;212133;118395;131541;240121;9815;249936;278264
2307403;CE;Jucás;22632;11762;12047;14150;9659;23809;24949
2307502;CE;Lavras da Mangabeira;31203;15571;15525;18138;12958;31096;31476
2307601;CE;Limoeiro do Norte;49620;27573;28708;32502;23779;56281;60232
2307635;CE;Madalena;14864;9083;9002;8915;9170;18085;20031
2307650;CE;Maracanaú;179732;102453;107295;208848;900;209748;230986
2307700;CE;Maranguape;88135;56260;56666;86873;26053;112926;131677
2307809;CE;Marco;20427;12601;12106;15435;9272;24707;27822
2307908;CE;Martinópole;8602;5097;5123;8009;2211;10220;11407
2308005;CE;Massapê;29574;17449;17752;23993;11208;35201;39341
2308104;CE;Mauriti;42399;22079;22138;23282;20935;44217;48370
2308203;CE;Meruoca;11339;6874;6819;7420;6273;13693;15309
2308302;CE;Milagres;26959;13932;14385;13558;14759;28317;27413
2308351;CE;Milhã;13028;6523;6555;5969;7109;13078;13129
2308377;CE;Miraíma;11417;6607;6193;6847;5953;12800;13965
2308401;CE;Missão Velha;32586;16894;17364;15413;18845;34258;35566
2308500;CE;Mombaça;41215;21256;21451;18828;23879;42707;43917
2308609;CE;Monsenhor Tabosa;16344;8295;8411;9363;7343;16706;17264
2308708;CE;Morada Nova;64400;31147;30939;35412;26674;62086;61590
2308807;CE;Moraújo;7046;4069;4000;3603;4466;8069;8833
2308906;CE;Morrinhos;17928;10442;10261;9615;11088;20703;22830
2309003;CE;Mucambo;13811;6699;7403;9066;5036;14102;14561
2309102;CE;Mulungu;8897;5842;5643;4198;7287;11485;11056
2309201;CE;Nova Olinda;12077;7020;7236;9696;4560;14256;15798
2309300;CE;Nova Russas;29347;15030;15947;23256;7721;30977;32487
2309409;CE;Novo Oriente;26119;13552;13909;14237;13224;27461;28737
2309458;CE;Ocara;21584;12318;11694;7605;16407;24012;25958
2309508;CE;Orós;22023;10424;10968;16026;5366;21392;21342
2309607;CE;Pacajus;44070;30375;31471;50681;11165;61846;74145
2309706;CE;Pacatuba;51696;35581;36668;62061;10188;72249;85647
2309805;CE;Pacoti;10929;5851;5756;4745;6862;11607;12313
2309904;CE;Pacujá;5653;2902;3084;3723;2263;5986;6565
2310001;CE;Palhano;8166;4471;4398;4518;4351;8869;9458
2310100;CE;Palmácia;9859;6002;6003;4957;7048;12005;13553
2310209;CE;Paracuru;27541;15856;15782;20590;11048;31638;35526
2310258;CE;Paraipaba;25462;15291;14750;13435;16606;30041;33232
2310308;CE;Parambu;32302;15269;16051;14115;17205;31320;31391
2310407;CE;Paramoti;10970;5814;5494;5540;5768;11308;12276
2310506;CE;Pedra Branca;40742;20705;21237;24549;17393;41942;43359
2310605;CE;Penaforte;7017;4044;4182;6399;1827;8226;9207
2310704;CE;Pentecoste;32600;17902;17510;21406;14006;35412;38045
2310803;CE;Pereiro;15225;7766;7998;5433;10331;15764;16356
2310852;CE;Pindoretama;14951;9345;9346;11289;7402;18691;20964
2310902;CE;Piquet Carneiro;13131;7804;7697;7451;8050;15501;17210
2310951;CE;Pires Ferreira;8643;5139;5077;3354;6862;10216;11052
2311009;CE;Poranga;11737;5976;6027;7800;4203;12003;12358
2311108;CE;Porteiras;15658;7370;7695;6179;8886;15065;14920
2311207;CE;Potengi;9138;4987;5289;5714;4562;10276;11165
2311231;CE;Potiretama;5768;3161;2968;2707;3422;6129;6455
2311264;CE;Quiterianópolis;18355;9853;10065;6305;13613;19918;21246
2311306;CE;Quixadá;69654;39768;40837;57482;23123;80605;88899
2311355;CE;Quixelô;15596;7549;7451;4929;10071;15000;16116
2311405;CE;Quixeramobim;59235;35739;36173;43446;28466;71912;82455
2311504;CE;Quixeré;16862;9712;9710;11936;7486;19422;22432
2311603;CE;Redenção;24993;13133;13290;15142;11281;26423;29238
2311702;CE;Reriutaba;21224;9683;9777;10590;8870;19460;18279
2311801;CE;Russas;57320;34430;35462;45007;24885;69892;79550
2311900;CE;Saboeiro;16226;7763;7991;8457;7297;15754;15757
2311959;CE;Salitre;13925;7770;7683;6263;9190;15453;16714
2312007;CE;Santana do Acaraú;26198;15182;14795;15402;14575;29977;32851
2312106;CE;Santana do Cariri;16847;8641;8540;8824;8357;17181;17726
2312205;CE;Santa Quitéria;42375;21436;21323;22257;20502;42759;43719
2312304;CE;São Benedito;39894;21832;22354;24556;19630;44186;48354
2312403;CE;São Gonçalo do Amarante;35608;22382;21565;28581;15366;43947;49306
2312502;CE;São João do Jaguaribe;8650;3853;4049;3169;4733;7902;7557
2312601;CE;São Luís do Curu;11497;6145;6191;7963;4373;12336;13086
2312700;CE;Senador Pompeu;27225;13033;13461;15715;10779;26494;25418
2312809;CE;Senador Sá;5605;3431;3421;5068;1784;6852;7758
2312908;CE;Sobral;155276;91475;96796;166333;21938;188271;212437
2313005;CE;Solonópole;16902;8831;8826;9102;8555;17657;18389
2313104;CE;Tabuleiro do Norte;27098;14217;14993;18812;10398;29210;32079
2313203;CE;Tamboril;25973;12633;12822;14206;11249;25455;26199
2313252;CE;Tarrafas;9213;4452;4458;2624;6286;8910;8555
2313302;CE;Tauá;51948;27366;28389;32280;23475;55755;59259
2313351;CE;Tejuçuoca;13519;8611;8225;6333;10503;16836;19551
2313401;CE;Tianguá;58069;34179;34722;45828;23073;68901;77111
2313500;CE;Trairi;44527;26443;24989;18787;32645;51432;56653
2313559;CE;Tururu;11498;7474;6941;5295;9120;14415;16588
2313609;CE;Ubajara;27095;15764;16028;15350;16442;31792;35295
2313708;CE;Umari;7435;3772;3773;3918;3627;7545;7740
2313757;CE;Umirim;17343;9643;9164;11096;7711;18807;19976
2313807;CE;Uruburetama;16444;9928;9837;14686;5079;19765;22223
2313906;CE;Uruoca;11479;6503;6391;7671;5223;12894;13988
2313955;CE;Varjota;16593;8701;8883;14413;3171;17584;18520
2314003;CE;Várzea Alegre;34844;18664;19778;23898;14544;38442;41078
2314102;CE;Viçosa do Ceará;45427;27668;27293;17827;37134;54961;61916
2400109;RN;Acari;11189;5364;5671;8902;2133;11035;11106
2400208;RN;Açu;47904;26158;27087;39369;13876;53245;58743
2400307;RN;Afonso Bezerra;10867;5464;5415;5760;5119;10879;11024
2400406;RN;Água Nova;2678;1480;1504;1908;1076;2984;3293
2400505;RN;Alexandria;13772;6602;6873;9188;4287;13475;13529
2400604;RN;Almino Afonso;5195;2499;2381;3488;1392;4880;4685
2400703;RN;Alto do Rodrigues;9499;6163;6143;8875;3431;12306;14923
2400802;RN;Angicos;11626;5657;5896;10089;1464;11553;11695
2400901;RN;Antônio Martins;6757;3494;3413;3784;3123;6907;7162
2401008;RN;Apodi;34174;17376;17401;17545;17232;34777;35904
2401107;RN;Areia Branca;22530;12311;12952;20258;5005;25263;28156
2401206;RN;Arês;11323;6405;6526;8080;4851;12931;14526
2401305;RN;Augusto Severo;9024;4708;4581;5002;4287;9289;9686
2401404;RN;Baía Formosa;7821;4335;4234;7128;1441;8569;9373
2401453;RN;Baraúna;18922;12272;11915;15215;8972;24187;29112
2401503;RN;Barcelona;3990;2028;1929;1756;2201;3957;3989
2401602;RN;Bento Fernandes;4709;2629;2481;2066;3044;5110;5552
2401651;RN;Bodó;2775;1260;1165;1393;1032;2425;2171
2401701;RN;Bom Jesus;8608;4691;4741;6766;2666;9432;10323
2401800;RN;Brejinho;10317;5798;5779;9167;2410;11577;12873
2401859;RN;Caiçara do Norte;5842;3119;2897;5894;122;6016;6572
2401909;RN;Caiçara do Rio do Vento;2867;1641;1663;2522;782;3304;3745
2402006;RN;Caicó;57002;30371;32356;57464;5263;62727;68726
2402105;RN;Campo Redondo;9201;5104;5162;5197;5069;10266;11363
2402204;RN;Canguaretama;27011;15461;15439;20210;10690;30900;34814
2402303;RN;Caraúbas;18810;9571;10011;13709;5873;19582;20588
2402402;RN;Carnaúba dos Dantas;6572;3716;3713;6028;1401;7429;8297
2402501;RN;Carnaubais;8192;4900;4875;4761;5014;9775;10972
2402600;RN;Ceará-Mirim;62424;33570;34274;35474;32370;67844;74268
2402709;RN;Cerro Corá;10839;5458;5458;4740;6176;10916;11182
2402808;RN;Coronel Ezequiel;5409;2747;2658;2273;3132;5405;5501
2402907;RN;Coronel João Pessoa;4703;2370;2404;1779;2995;4774;4918
2403004;RN;Cruzeta;8138;3907;4061;6522;1446;7968;7968
2403103;RN;Currais Novos;40791;20381;22287;37793;4875;42668;45022
2403202;RN;Doutor Severiano;6552;3194;3301;2783;3712;6495;7068
2403251;RN;Parnamirim;124690;96938;105475;202413;0;202413;272490
2403301;RN;Encanto;4798;2563;2665;2127;3101;5228;5697
2403400;RN;Equador;5664;2960;2862;4810;1012;5822;6064
2403509;RN;Espírito Santo;10715;5319;5161;5007;5473;10480;10463
2403608;RN;Extremoz;19572;12192;12358;15780;8770;24550;29282
2403707;RN;Felipe Guerra;5534;2869;2865;3875;1859;5734;6009
2403756;RN;Fernando Pedroza;2650;1458;1392;2430;420;2850;3081
2403806;RN;Florânia;8978;4492;4467;6857;2102;8959;9772
2403905;RN;Francisco Dantas;3021;1457;1417;1647;1227;2874;2801
2404002;RN;Frutuoso Gomes;4580;2072;2161;2812;1421;4233;4015
2404101;RN;Galinhos;1767;1112;1038;1240;910;2150;2903
2404200;RN;Goianinha;17661;11196;11271;15469;6998;22467;27004
2404309;RN;Governador Dix-Sept Rosado;11772;6321;6052;6804;5569;12373;13115
2404408;RN;Grossos;8249;4762;4631;7039;2354;9393;10541
2404507;RN;Guamaré;8149;6230;6201;4405;8026;12431;16261
2404606;RN;Ielmo Marinho;10249;6280;5908;1538;10650;12188;14033
2404705;RN;Ipanguaçu;11924;6999;6856;5382;8473;13855;15759
2404804;RN;Ipueira;1902;1036;1038;1886;188;2074;2264
2404853;RN;Itajá;6249;3546;3406;5704;1248;6952;7641
2404903;RN;Itaú;5271;2742;2826;4790;778;5568;5916
2405009;RN;Jaçanã;7677;3935;3990;5333;2592;7925;9341
2405108;RN;Jandaíra;6124;3513;3283;3954;2842;6796;6907
2405207;RN;Janduís;5597;2653;2697;3997;1353;5350;5228
2405306;RN;Januário Cicco;7687;4635;4374;3210;5799;9009;10367
2405405;RN;Japi;6328;2806;2716;4107;1415;5522;4935
2405504;RN;Jardim de Angicos;2670;1353;1254;433;2174;2607;2600
2405603;RN;Jardim de Piranhas;11994;6721;6790;10598;2913;13511;15044
2405702;RN;Jardim do Seridó;12041;5886;6229;9835;2280;12115;12397
2405801;RN;João Câmara;29248;16033;16170;22631;9572;32203;35360
2405900;RN;João Dias;2596;1279;1322;1167;1434;2601;2653
2406007;RN;José da Penha;5908;2822;3046;3542;2326;5868;5941
2406106;RN;Jucurutu;17319;8869;8823;10567;7125;17692;18335
2406155;RN;Jundiá;0;1876;1709;962;2623;3585;3945
2406205;RN;Lagoa dAnta;5629;3132;3096;3983;2245;6228;6851
2406304;RN;Lagoa de Pedras;6395;3566;3426;2237;4755;6992;7624
2406403;RN;Lagoa de Velhos;2651;1365;1309;1795;879;2674;2732
2406502;RN;Lagoa Nova;12058;6927;7063;6805;7185;13990;15880
2406601;RN;Lagoa Salgada;6808;3800;3765;5006;2559;7565;8348
2406700;RN;Lajes;9399;5163;5222;8076;2309;10385;11410
2406809;RN;Lajes Pintadas;4530;2349;2265;2392;2222;4614;4768
2406908;RN;Lucrécia;3218;1829;1804;2280;1353;3633;4053
2407005;RN;Luís Gomes;9154;4723;4889;6688;2924;9612;10175
2407104;RN;Macaíba;54883;34485;35053;42686;26852;69538;82828
2407203;RN;Macau;25700;14200;14774;21986;6988;28974;32260
2407252;RN;Major Sales;2948;1749;1787;2900;636;3536;4102
2407302;RN;Marcelino Vieira;8373;4064;4201;4894;3371;8265;8325
2407401;RN;Martins;7725;4045;4183;5046;3182;8228;8790
2407500;RN;Maxaranguape;8001;5352;5090;3889;6553;10442;12714
2407609;RN;Messias Targino;3718;2119;2069;3638;550;4188;4665
2407708;RN;Montanhas;11948;5666;5752;8875;2543;11418;11166
2407807;RN;Monte Alegre;18874;10268;10402;8993;11677;20670;22698
2407906;RN;Monte das Gameleiras;2541;1154;1112;1283;983;2266;2063
2408003;RN;Mossoró;213841;125694;134192;237281;22605;259886;303792
2408102;RN;Natal;712317;378004;425807;803811;0;803811;896708
2408201;RN;Nísia Floresta;19040;12326;11492;9380;14438;23818;28266
2408300;RN;Nova Cruz;33834;17534;18007;24427;11114;35541;37554
2408409;RN;Olho-dÁgua do Borges;4461;2214;2087;3243;1058;4301;4231
2408508;RN;Ouro Branco;4667;2354;2345;3258;1441;4699;4813
2408607;RN;Paraná;3633;2041;1911;821;3131;3952;4298
2408706;RN;Paraú;4092;1923;1939;3338;524;3862;3732
2408805;RN;Parazinho;4325;2434;2411;3137;1708;4845;5307
2408904;RN;Parelhas;19319;9958;10389;17077;3270;20347;21611
2408953;RN;Rio do Fogo;9217;5132;4928;3747;6313;10060;10961
2409100;RN;Passa e Fica;8329;5514;5597;6765;4346;11111;13667
2409209;RN;Passagem;2691;1455;1444;1193;1706;2899;3114
2409308;RN;Patu;11171;5886;6078;10159;1805;11964;12861
2409332;RN;Santa Maria;3778;2419;2343;3051;1711;4762;5689
2409407;RN;Pau dos Ferros;24758;13500;14233;25535;2198;27733;30802
2409506;RN;Pedra Grande;4017;1772;1749;1161;2360;3521;3163
2409605;RN;Pedra Preta;2847;1337;1246;990;1593;2583;2419
2409704;RN;Pedro Avelino;8006;3697;3471;4119;3049;7168;6591
2409803;RN;Pedro Velho;13518;7162;6957;7252;6867;14119;14881
2409902;RN;Pendências;11401;6696;6740;10576;2860;13436;15411
2410009;RN;Pilões;3002;1729;1724;2533;920;3453;3900
2410108;RN;Poço Branco;12261;7051;6896;7413;6534;13947;15646
2410207;RN;Portalegre;6746;3573;3724;3838;3459;7297;7944
2410256;RN;Porto do Mangue;4064;2731;2486;3028;2189;5217;6605
2410306;RN;Presidente Juscelino;7005;4476;4298;5313;3461;8774;10646
2410405;RN;Pureza;6963;4286;4146;2995;5437;8432;9825
2410504;RN;Rafael Fernandes;4247;2328;2364;2709;1983;4692;5158
2410603;RN;Rafael Godeiro;2953;1541;1529;1929;1141;3070;3214
2410702;RN;Riacho da Cruz;2667;1617;1548;2674;491;3165;3648
2410801;RN;Riacho de Santana;4200;2073;2084;1710;2447;4157;4194
2410900;RN;Riachuelo;5760;3560;3507;4342;2725;7067;8310
2411007;RN;Rodolfo Fernandes;4467;2172;2245;3731;686;4417;4457
2411056;RN;Tibau;3197;1847;1840;2835;852;3687;4173
2411106;RN;Ruy Barbosa;3686;1834;1761;1736;1859;3595;3584
2411205;RN;Santa Cruz;31294;17449;18310;30461;5298;35759;40295
2411403;RN;Santana do Matos;15987;6860;6938;6893;6905;13798;11808
2411429;RN;Santana do Seridó;2377;1267;1259;1653;873;2526;2699
2411502;RN;Santo Antônio;20107;11098;11116;14278;7936;22214;24422
2411601;RN;São Bento do Norte;3378;1523;1451;1033;1941;2974;2687
2411700;RN;São Bento do Trairí;3244;1940;1969;1886;2023;3909;4541
2411809;RN;São Fernando;3234;1737;1664;2297;1104;3401;3606
2411908;RN;São Francisco do Oeste;3480;1945;1929;2948;926;3874;4281
2412005;RN;São Gonçalo do Amarante;69435;43208;44492;74136;13564;87700;104919
2412104;RN;São João do Sabugi;5698;2923;2991;4748;1166;5914;6221
2412203;RN;São José de Mipibu;34912;19820;19951;18230;21541;39771;44566
2412302;RN;São José do Campestre;11982;6151;6208;10272;2087;12359;12901
2412401;RN;São José do Seridó;3777;2122;2109;3302;929;4231;4696
2412500;RN;São Miguel;20124;10573;11586;14502;7657;22159;23789
2412559;RN;São Miguel do Gostoso;7580;4476;4183;4127;4532;8659;10441
2412609;RN;São Paulo do Potengi;13822;7822;8044;11490;4376;15866;17858
2412708;RN;São Pedro;6776;3160;3063;3492;2731;6223;5889
2412807;RN;São Rafael;8201;4128;3978;5538;2568;8106;8183
2412906;RN;São Tomé;10798;5457;5411;5982;4886;10868;11051
2413003;RN;São Vicente;5633;2945;3085;3767;2263;6030;6476
2413102;RN;Senador Elói de Souza;5028;2866;2779;2434;3211;5645;6167
2413201;RN;Senador Georgino Avelino;3302;1944;1980;3881;43;3924;4527
2413300;RN;Serra de São Bento;5870;2867;2879;3262;2484;5746;5739
2413359;RN;Serra do Mel;8237;5392;4889;2698;7583;10281;12225
2413409;RN;Serra Negra do Norte;7543;3901;3869;4997;2773;7770;8105
2413508;RN;Serrinha;7253;3452;3129;2121;4460;6581;6128
2413557;RN;Serrinha dos Pintos;4295;2291;2247;2402;2136;4538;4832
2413607;RN;Severiano Melo;10579;2865;2887;2118;3634;5752;1743
2413706;RN;Sítio Novo;4448;2542;2478;2390;2630;5020;5600
2413805;RN;Taboleiro Grande;2029;1178;1139;1887;430;2317;2606
2413904;RN;Taipu;11531;6112;5724;4084;7752;11836;12314
2414001;RN;Tangará;12118;7159;7016;9734;4441;14175;16008
2414100;RN;Tenente Ananias;8875;5003;4908;6833;3078;9911;10923
2414159;RN;Tenente Laurentino Cruz;4412;2746;2660;1152;4254;5406;6085
2414209;RN;Tibau do Sul;7749;5762;5640;6870;4532;11402;14694
2414308;RN;Timbaúba dos Batistas;2189;1145;1150;1728;567;2295;2427
2414407;RN;Touros;27879;16056;15020;7910;23166;31076;33716
2414456;RN;Triunfo Potiguar;3642;1768;1598;2197;1169;3366;3195
2414506;RN;Umarizal;11092;5224;5445;9084;1585;10669;10485
2414605;RN;Upanema;10991;6715;6270;6298;6687;12985;14937
2414704;RN;Várzea;8238;2614;2613;4311;916;5227;5529
2414753;RN;Venha-Ver;3422;1952;1869;1199;2622;3821;4232
2414803;RN;Vera Cruz;8522;5352;5373;4691;6034;10725;12789
2414902;RN;Viçosa;1521;806;812;1541;77;1618;1731
2415008;RN;Vila Flor;2528;1460;1412;2784;88;2872;3217
2500106;PB;Água Branca;8377;4720;4729;4061;5388;9449;10375
2500205;PB;Aguiar;5638;2706;2824;2701;2829;5530;5622
2500304;PB;Alagoa Grande;29169;13862;14620;17532;10950;28482;28384
2500403;PB;Alagoa Nova;18575;9764;9922;9797;9889;19686;20992
2500502;PB;Alagoinha;11833;6706;6871;9033;4544;13577;14629
2500536;PB;Alcantil;4958;2626;2613;2064;3175;5239;5527
2500577;PB;Algodão de Jandaíra;2209;1218;1148;1231;1135;2366;2588
2500601;PB;Alhandra;15914;8863;9138;11146;6855;18001;19865
2500700;PB;São João do Rio do Peixe;17661;8940;9261;6885;11316;18201;18020
2500734;PB;Amparo;1886;1047;1041;1062;1026;2088;2264
2500775;PB;Aparecida;5894;3796;3880;3638;4038;7676;8482
2500809;PB;Araçagi;18095;8574;8650;6804;10420;17224;16857
2500908;PB;Arara;11530;6074;6579;8924;3729;12653;13613
2501005;PB;Araruna;16605;9328;9558;9330;9556;18886;20610
2501104;PB;Areia;26131;11668;12169;14602;9235;23837;22493
2501153;PB;Areia de Baraúnas;2104;963;964;1017;910;1927;2105
2501203;PB;Areial;6039;3060;3410;4600;1870;6470;7054
2501302;PB;Aroeiras;19520;9227;9862;9538;9551;19089;19081
2501351;PB;Assunção;2960;1779;1743;2846;676;3522;4067
2501401;PB;Baía da Traição;6483;4035;3972;3091;4916;8007;9197
2501500;PB;Bananeiras;21810;10786;11068;8667;13187;21854;21220
2501534;PB;Baraúna;3169;2111;2111;3189;1033;4222;5033
2501575;PB;Barra de Santana;8311;4146;4059;731;7474;8205;8338
2501609;PB;Barra de Santa Rosa;13127;7087;7073;7959;6201;14160;15607
2501708;PB;Barra de São Miguel;5162;2918;2693;2364;3247;5611;6095
2501807;PB;Bayeux;87561;47753;52005;98834;924;99758;97519
2501906;PB;Belém;16605;8344;8739;14102;2981;17083;17733
2502003;PB;Belém do Brejo do Cruz;7011;3607;3536;5260;1883;7143;7356
2502052;PB;Bernardino Batista;2559;1476;1599;858;2217;3075;3571
2502102;PB;Boa Ventura;6588;2899;2852;3522;2229;5751;5248
2502151;PB;Boa Vista;4983;3084;3140;3205;3019;6224;7218
2502201;PB;Bom Jesus;2193;1221;1178;991;1408;2399;2588
2502300;PB;Bom Sucesso;5285;2477;2560;2030;3007;5037;4937
2502409;PB;Bonito de Santa Fé;9230;5351;5455;7401;3405;10806;12126
2502508;PB;Boqueirão;15867;8325;8564;12008;4881;16889;17934
2502607;PB;Igaracy;6307;3018;3138;4121;2035;6156;6092
2502706;PB;Borborema;4730;2558;2553;3732;1379;5111;5311
2502805;PB;Brejo do Cruz;11868;6510;6613;9898;3225;13123;14287
2502904;PB;Brejo dos Santos;5948;3091;3106;4631;1566;6197;6479
2503001;PB;Caaporã;18441;10091;10272;17549;2814;20363;22079
2503100;PB;Cabaceiras;4290;2495;2540;2217;2818;5035;5710
2503209;PB;Cabedelo;42832;27623;30303;57918;8;57926;69773
2503308;PB;Cachoeira dos Índios;7834;4820;4726;3403;6143;9546;10364
2503407;PB;Cacimba de Areia;3577;1779;1778;1674;1883;3557;3708
2503506;PB;Cacimba de Dentro;16817;8219;8536;9164;7591;16755;17169
2503555;PB;Cacimbas;6979;3284;3530;1641;5173;6814;7225
2503605;PB;Caiçara;7325;3619;3601;5190;2030;7220;7182
2503704;PB;Cajazeiras;54715;27930;30507;47489;10948;58437;62576
2503753;PB;Cajazeirinhas;2848;1548;1485;1000;2033;3033;3217
2503803;PB;Caldas Brandão;5155;2803;2834;3224;2413;5637;6077
2503902;PB;Camalaú;5516;2841;2908;2887;2862;5749;6048
2504009;PB;Campina Grande;355331;182249;203027;367278;17998;385276;413830
2504033;PB;Capim;4180;2815;2786;4106;1495;5601;6715
2504074;PB;Caraúbas;3401;1972;1927;1517;2382;3899;4206
2504108;PB;Carrapateira;2160;1247;1131;1713;665;2378;2714
2504157;PB;Casserengue;6568;3549;3509;3458;3600;7058;7530
2504207;PB;Catingueira;4748;2413;2399;2884;1928;4812;4938
2504306;PB;Catolé do Rocha;26641;14038;14728;21327;7439;28766;30819
2504355;PB;Caturité;4183;2301;2245;1025;3521;4546;4898
2504405;PB;Conceição;17931;9121;9245;11436;6930;18366;19030
2504504;PB;Condado;6495;3217;3370;4564;2023;6587;6662
2504603;PB;Conde;16413;10773;10645;14495;6923;21418;25341
2504702;PB;Congo;4602;2380;2312;2944;1748;4692;4787
2504801;PB;Coremas;15130;7419;7730;11419;3730;15149;15438
2504850;PB;Coxixola;1422;916;855;782;989;1771;1948
2504900;PB;Cruz do Espírito Santo;14081;8093;8164;7440;8817;16257;17599
2505006;PB;Cubati;6388;3392;3476;4772;2096;6868;7866
2505105;PB;Cuité;19946;9818;10132;13462;6488;19950;20331
2505204;PB;Cuitegi;7254;3389;3500;5608;1281;6889;6748
2505238;PB;Cuité de Mamanguape;6124;3099;3099;2065;4133;6198;6360
2505279;PB;Curral de Cima;5323;2632;2582;473;4741;5214;5209
2505303;PB;Curral Velho;2558;1305;1200;1410;1095;2505;2508
2505352;PB;Damião;3645;2460;2440;2278;2622;4900;5409
2505402;PB;Desterro;7701;3893;4098;4889;3102;7991;8332
2505501;PB;Vista Serrana;3121;1819;1689;1586;1922;3508;3850
2505600;PB;Diamante;6920;3331;3285;3818;2798;6616;6506
2505709;PB;Dona Inês;10227;5277;5240;4655;5862;10517;10375
2505808;PB;Duas Estradas;3818;1790;1850;2841;799;3640;3569
2505907;PB;Emas;3061;1673;1644;2132;1185;3317;3556
2506004;PB;Esperança;28166;15154;15941;21631;9464;31095;33386
2506103;PB;Fagundes;11892;5609;5800;5467;5942;11409;11180
2506202;PB;Frei Martinho;2923;1468;1465;1807;1126;2933;2989
2506251;PB;Gado Bravo;8521;4133;4243;908;7468;8376;8292
2506301;PB;Guarabira;51482;26699;28641;48974;6366;55340;59389
2506400;PB;Gurinhém;13182;6920;6952;5795;8077;13872;14125
2506509;PB;Gurjão;2789;1550;1609;2128;1031;3159;3477
2506608;PB;Ibiara;6383;3035;2996;3686;2345;6031;5877
2506707;PB;Imaculada;11577;5707;5645;5063;6289;11352;11877
2506806;PB;Ingá;17473;8838;9342;11599;6581;18180;18184
2506905;PB;Itabaiana;25207;11850;12633;19733;4750;24483;24363
2507002;PB;Itaporanga;21123;11392;11803;17632;5563;23195;24960
2507101;PB;Itapororoca;14633;8561;8437;10857;6141;16998;18978
2507200;PB;Itatuba;9374;5049;5152;5955;4246;10201;11069
2507309;PB;Jacaraú;14117;6924;7028;8042;5910;13952;14467
2507408;PB;Jericó;7416;3693;3845;4729;2809;7538;7751
2507507;PB;João Pessoa;597934;337745;385769;720789;2725;723514;825796
2507606;PB;Juarez Távora;7081;3641;3818;5852;1607;7459;8014
2507705;PB;Juazeirinho;14873;8366;8410;9124;7652;16776;18422
2507804;PB;Junco do Seridó;5968;3308;3335;4369;2274;6643;7238
2507903;PB;Juripiranga;9647;5131;5109;9589;651;10240;10830
2508000;PB;Juru;10045;4897;4929;4359;5467;9826;9831
2508109;PB;Lagoa;4844;2305;2376;2304;2377;4681;4640
2508208;PB;Lagoa de Dentro;7086;3626;3744;3975;3395;7370;7754
2508307;PB;Lagoa Seca;24154;12743;13168;10585;15326;25911;27728
2508406;PB;Lastro;3118;1438;1403;1335;1506;2841;2698
2508505;PB;Livramento;7605;3523;3641;3752;3412;7164;7274
2508554;PB;Logradouro;3389;1938;2004;1723;2219;3942;4406
2508604;PB;Lucena;9755;5826;5904;10152;1578;11730;13344
2508703;PB;Mãe dÁgua;3459;1964;2055;1569;2450;4019;3988
2508802;PB;Malta;5692;2702;2910;4904;708;5612;5745
2508901;PB;Mamanguape;38772;20807;21523;34248;8082;42330;45385
2509008;PB;Manaíra;10473;5400;5359;6027;4732;10759;10988
2509057;PB;Marcação;6203;3895;3716;2851;4760;7611;8746
2509107;PB;Mari;20663;10359;10814;17449;3724;21173;21895
2509156;PB;Marizópolis;5618;3016;3157;5357;816;6173;6689
2509206;PB;Massaranduba;11697;6250;6660;4487;8423;12910;14077
2509305;PB;Mataraca;5500;3687;3717;6544;860;7404;8642
2509339;PB;Matinhas;4086;2149;2167;682;3634;4316;4528
2509370;PB;Mato Grosso;2427;1349;1353;1201;1501;2702;2944
2509396;PB;Maturéia;5032;2900;3039;3857;2082;5939;6690
2509404;PB;Mogeiro;13231;6076;6414;5582;6908;12490;13238
2509503;PB;Montadas;3969;2482;2508;3156;1834;4990;5806
2509602;PB;Monte Horebe;4112;2263;2245;2501;2007;4508;4867
2509701;PB;Monteiro;27687;14976;15868;20259;10585;30844;33638
2509800;PB;Mulungu;9189;4630;4839;4536;4933;9469;9962
2509909;PB;Natuba;10562;5217;5349;3634;6932;10566;10449
2510006;PB;Nazarezinho;7272;3630;3650;3184;4096;7280;7271
2510105;PB;Nova Floresta;9421;5116;5417;7892;2641;10533;10614
2510204;PB;Nova Olinda;6457;3019;3051;3227;2843;6070;5892
2510303;PB;Nova Palmeira;3573;2166;2199;2556;1809;4365;5011
2510402;PB;Olho dÁgua;7831;3352;3579;3868;3063;6931;6399
2510501;PB;Olivedos;3194;1853;1774;1902;1725;3627;3989
2510600;PB;Ouro Velho;2823;1470;1458;2047;881;2928;3052
2510659;PB;Parari;1437;621;635;699;557;1256;1747
2510709;PB;Passagem;1979;1107;1126;1109;1124;2233;2453
2510808;PB;Patos;91761;47816;52879;97296;3399;100695;108766
2510907;PB;Paulista;11266;5825;5958;5717;6066;11783;12411
2511004;PB;Pedra Branca;3692;1847;1874;2365;1356;3721;3802
2511103;PB;Pedra Lavrada;6617;3734;3741;3075;4400;7475;7954
2511202;PB;Pedras de Fogo;25861;13468;13566;16360;10674;27034;28607
2511301;PB;Piancó;14872;7388;8077;11278;4187;15465;16147
2511400;PB;Picuí;17896;8957;9269;12122;6104;18226;18737
2511509;PB;Pilar;10274;5500;5691;7673;3518;11191;12036
2511608;PB;Pilões;7800;3517;3461;3332;3646;6978;6518
2511707;PB;Pilõezinhos;5430;2543;2612;2747;2408;5155;4937
2511806;PB;Pirpirituba;10198;5110;5209;7892;2427;10319;10590
2511905;PB;Pitimbu;13927;8611;8421;10392;6640;17032;19478
2512002;PB;Pocinhos;14880;8485;8535;9615;7405;17020;18848
2512036;PB;Poço Dantas;3828;1905;1847;977;2775;3752;3877
2512077;PB;Poço de José de Moura;3529;1935;2043;1425;2553;3978;4366
2512101;PB;Pombal;31954;15381;16736;25760;6357;32117;32803
2512200;PB;Prata;3425;1927;1927;2444;1410;3854;4265
2512309;PB;Princesa Isabel;18231;10448;10835;14528;6755;21283;23749
2512408;PB;Puxinanã;11981;6362;6567;4219;8710;12929;13801
2512507;PB;Queimadas;36032;19942;21112;22249;18805;41054;44388
2512606;PB;Quixabá;1308;893;806;633;1066;1699;2009
2512705;PB;Remígio;14914;8380;9202;12954;4628;17582;19973
2512721;PB;Pedro Régis;4883;2899;2880;2148;3631;5779;6139
2512747;PB;Riachão;2793;1595;1679;2031;1243;3274;3650
2512754;PB;Riachão do Bacamarte;3948;2082;2182;2663;1601;4264;4562
2512762;PB;Riachão do Poço;3694;2086;2078;1287;2877;4164;4571
2512788;PB;Riacho de Santo Antônio;1334;871;851;1186;536;1722;1999
2512804;PB;Riacho dos Cavalos;8064;4242;4072;4025;4289;8314;8555
2512903;PB;Rio Tinto;22311;11311;11668;13060;9919;22979;24258
2513000;PB;Salgadinho;2823;1782;1726;1203;2305;3508;3975
2513109;PB;Salgado de São Félix;12046;5836;6140;5250;6726;11976;12123
2513158;PB;Santa Cecília;6862;3411;3250;1868;4793;6661;6526
2513208;PB;Santa Cruz;6471;3283;3188;2988;3483;6471;6579
2513307;PB;Santa Helena;6170;2626;2743;2702;2667;5369;5853
2513356;PB;Santa Inês;3548;1823;1716;1430;2109;3539;3591
2513406;PB;Santa Luzia;14012;7142;7587;13489;1240;14729;15470
2513505;PB;Santana de Mangueira;5773;2698;2634;2232;3100;5332;5098
2513604;PB;Santana dos Garrotes;7882;3512;3754;3736;3530;7266;6942
2513653;PB;Santarém;2568;1268;1347;840;1775;2615;2640
2513703;PB;Santa Rita;115844;58143;62190;103768;16565;120333;138093
2513802;PB;Santa Teresinha;4728;2276;2305;2208;2373;4581;4550
2513851;PB;Santo André;2800;1337;1301;865;1773;2638;2496
2513901;PB;São Bento;26225;15219;15661;25039;5841;30880;34650
2513927;PB;São Bentinho;3589;2018;2120;2845;1293;4138;4602
2513943;PB;São Domingos do Cariri;2189;1212;1208;1034;1386;2420;2645
2513968;PB;São Domingos;2498;1410;1441;994;1857;2851;3119
2513984;PB;São Francisco;3464;1660;1704;1363;2001;3364;3377
2514008;PB;São João do Cariri;4703;2121;2223;2347;1997;4344;4170
2514107;PB;São João do Tigre;4481;2247;2149;1529;2867;4396;4408
2514206;PB;São José da Lagoa Tapada;7184;3680;3884;3315;4249;7564;7622
2514305;PB;São José de Caiana;5737;3052;2958;2729;3281;6010;6394
2514404;PB;São José de Espinharas;5109;2501;2259;1617;3143;4760;4631
2514453;PB;São José dos Ramos;4900;2759;2749;2373;3135;5508;6037
2514503;PB;São José de Piranhas;17876;9530;9569;10798;8301;19099;20406
2514552;PB;São José de Princesa;4970;2139;2080;695;3524;4219;3898
2514602;PB;São José do Bonfim;2838;1627;1606;1361;1872;3233;3619
2514651;PB;São José do Brejo do Cruz;1532;849;835;958;726;1684;1821
2514701;PB;São José do Sabugi;3903;2042;1968;2579;1431;4010;4153
2514800;PB;São José dos Cordeiros;4136;1982;2003;1643;2342;3985;3607
2514909;PB;São Mamede;8018;3837;3911;5929;1819;7748;7682
2515005;PB;São Miguel de Taipu;6086;3342;3354;2977;3719;6696;7450
2515104;PB;São Sebastião de Lagoa de Roça;10026;5423;5618;4659;6382;11041;11793
2515203;PB;São Sebastião do Umbuzeiro;2894;1619;1620;2097;1142;3239;3534
2515302;PB;Sapé;47353;24658;25493;38149;12002;50151;52977
2515401;PB;Seridó;9106;5261;4969;4597;5633;10230;10919
2515500;PB;Serra Branca;12275;6331;6640;8417;4554;12971;13807
2515609;PB;Serra da Raiz;3436;1594;1610;2135;1069;3204;3114
2515708;PB;Serra Grande;2855;1502;1473;1776;1199;2975;2921
2515807;PB;Serra Redonda;7307;3361;3693;3611;3443;7054;7001
2515906;PB;Serraria;6678;3093;3145;3467;2771;6238;6037
2515930;PB;Sertãozinho;3444;2143;2252;3215;1180;4395;5152
2515971;PB;Sobrado;6885;3674;3689;883;6480;7363;7845
2516003;PB;Solânea;30658;12760;13929;19332;7357;26689;26051
2516102;PB;Soledade;12061;6770;6969;10231;3508;13739;15211
2516151;PB;Sossêgo;2598;1582;1591;1586;1587;3173;3631
2516201;PB;Sousa;62635;31799;34008;51885;13922;65807;69997
2516300;PB;Sumé;15035;7931;8141;12240;3832;16072;17096
2516409;PB;Tacima;9388;5159;5104;4371;5892;10263;11024
2516508;PB;Taperoá;13299;7346;7592;8941;5997;14938;15505
2516607;PB;Tavares;13584;7034;7069;6616;7487;14103;14791
2516706;PB;Teixeira;11953;6934;7219;9631;4522;14153;15333
2516755;PB;Tenório;2473;1468;1348;1676;1140;2816;3103
2516805;PB;Triunfo;9053;4573;4650;4312;4911;9223;9473
2516904;PB;Uiraúna;13681;7014;7570;10349;4235;14584;15356
2517001;PB;Umbuzeiro;9192;4508;4792;3986;5314;9300;9914
2517100;PB;Várzea;2051;1268;1236;1835;669;2504;2870
2517209;PB;Vieirópolis;4672;2538;2507;996;4049;5045;5395
2517407;PB;Zabelê;1853;1052;1023;1472;603;2075;2269
2600054;PE;Abreu e Lima;89039;45165;49263;86589;7839;94428;100698
2600104;PE;Afogados da Ingazeira;32922;16790;18301;27406;7685;35091;37546
2600203;PE;Afrânio;15014;8751;8837;5859;11729;17588;19981
2600302;PE;Agrestina;20036;10938;11742;16955;5725;22680;25240
2600401;PE;Água Preta;28531;16581;16465;18708;14338;33046;37386
2600500;PE;Águas Belas;36641;19545;20462;24300;15707;40007;43923
2600609;PE;Alagoinha;12535;6906;6855;7770;5991;13761;14798
2600708;PE;Aliança;37189;18579;18835;20249;17165;37414;38408
2600807;PE;Altinho;22131;11114;11249;12781;9582;22363;22996
2600906;PE;Amaraji;21309;10982;10943;16033;5892;21925;22910
2601003;PE;Angelim;9082;5019;5185;6089;4115;10204;11301
2601052;PE;Araçoiaba;15108;9014;9130;15261;2883;18144;20936
2601102;PE;Araripina;70898;37884;39479;46975;30388;77363;85301
2601201;PE;Arcoverde;61600;32563;36594;62899;6258;69157;75295
2601300;PE;Barra de Guabiraba;10939;6506;6259;11379;1386;12765;14632
2601409;PE;Barreiros;39139;19881;20839;33969;6751;40720;42866
2601508;PE;Belém de Maria;10626;5637;5712;7988;3361;11349;12169
2601607;PE;Belém do São Francisco;20208;9944;10292;12582;7654;20236;20730
2601706;PE;Belo Jardim;68698;34765;37647;58208;14204;72412;76930
2601805;PE;Betânia;11305;6014;5991;3709;8296;12005;12811
2601904;PE;Bezerros;57371;28051;30624;49747;8928;58675;60960
2602001;PE;Bodocó;31731;17643;17535;12836;22342;35178;38605
2602100;PE;Bom Conselho;42085;22010;23496;29782;15724;45506;48975
2602209;PE;Bom Jardim;37013;18461;19367;15191;22637;37828;40038
2602308;PE;Bonito;37750;18575;18995;26210;11360;37570;38101
2602407;PE;Brejão;8916;4338;4513;3571;5280;8851;8981
2602506;PE;Brejinho;7278;3608;3699;3386;3921;7307;7489
2602605;PE;Brejo da Madre de Deus;38109;22150;23042;35135;10057;45192;51696
2602704;PE;Buenos Aires;12007;6197;6340;7917;4620;12537;13224
2602803;PE;Buíque;44169;25572;26418;21121;30869;51990;59448
2602902;PE;Cabo de Santo Agostinho;152977;90887;94236;167830;17293;185123;210796
2603009;PE;Cabrobó;26741;15060;15823;19811;11072;30883;34778
2603108;PE;Cachoeirinha;17042;9110;9723;15221;3612;18833;20618
2603207;PE;Caetés;24137;13172;13405;7520;19057;26577;29065
2603306;PE;Calçado;11709;5566;5559;3810;7315;11125;10983
2603405;PE;Calumbi;7079;2723;2928;2181;3470;5651;5744
2603454;PE;Camaragibe;128702;69237;75269;144506;0;144506;159945
2603504;PE;Camocim de São Félix;15115;8323;8781;14329;2775;17104;19032
2603603;PE;Camutanga;7844;4081;4066;6525;1622;8147;8592
2603702;PE;Canhotinho;24920;12375;12161;14121;10415;24536;24743
2603801;PE;Capoeiras;19556;9772;9821;6263;13330;19593;20048
2603900;PE;Carnaíba;17696;9170;9415;7633;10952;18585;19666
2603926;PE;Carnaubeira da Penha;10404;6001;5781;1982;9800;11782;13117
2604007;PE;Carpina;63811;35540;39311;72061;2790;74851;85131
2604106;PE;Caruaru;253634;149146;165805;278098;36853;314951;369343
2604155;PE;Casinhas;13345;6813;6978;1688;12103;13791;14395
2604205;PE;Catende;31257;18305;19525;28877;8953;37830;43778
2604304;PE;Cedro;9551;5391;5387;6291;4487;10778;11972
2604403;PE;Chã de Alegria;11102;6078;6297;9515;2860;12375;13641
2604502;PE;Chã Grande;18407;9910;10110;13670;6350;20020;21929
2604601;PE;Condado;21797;11850;12448;22657;1641;24298;26755
2604700;PE;Correntes;17044;8609;8812;10329;7092;17421;18327
2604809;PE;Cortês;12681;6186;6272;7905;4553;12458;12543
2604908;PE;Cumaru;27489;8506;8660;8032;9134;17166;9494
2605004;PE;Cupira;22383;11043;12349;20790;2602;23392;24237
2605103;PE;Custódia;29969;16850;17455;21947;12358;34305;37633
2605152;PE;Dormentes;14411;8655;8260;6004;10911;16915;19246
2605202;PE;Escada;57341;31151;32384;53985;9550;63535;69701
2605301;PE;Exu;32423;15485;16151;16303;15333;31636;31709
2605400;PE;Feira Nova;18857;9980;10608;16329;4259;20588;22360
2605459;PE;Fernando de Noronha;2051;1294;1335;2629;0;2629;3140
2605509;PE;Ferreiros;10727;5656;5781;9169;2268;11437;12216
2605608;PE;Flores;20823;10939;11232;9364;12807;22171;22612
2605707;PE;Floresta;24729;14427;14857;19972;9312;29284;33488
2605806;PE;Frei Miguelinho;12978;6963;7268;3383;10848;14231;15633
2605905;PE;Gameleira;24003;14104;13811;19504;8411;27915;31578
2606002;PE;Garanhuns;117749;60962;68430;115344;14048;129392;141347
2606101;PE;Glória do Goitá;27554;14503;15172;15631;14044;29675;30847
2606200;PE;Goiana;71177;36651;38997;58045;17603;75648;80345
2606309;PE;Granito;6110;3453;3404;3178;3679;6857;7586
2606408;PE;Gravatá;67273;37032;39637;68389;8280;76669;85309
2606507;PE;Iati;17691;9124;9147;7718;10553;18271;19284
2606606;PE;Ibimirim;24340;13336;13623;14897;12062;26959;29585
2606705;PE;Ibirajuba;7438;3791;3743;3140;4394;7534;7773
2606804;PE;Igarassu;82277;49313;52674;93888;8099;101987;119690
2606903;PE;Iguaraci;11486;5915;5865;6112;5668;11780;12265
2607000;PE;Inajá;13280;9554;9527;7958;11123;19081;24034
2607109;PE;Ingazeira;4567;2290;2206;2456;2040;4496;4537
2607208;PE;Ipojuca;59281;39840;40702;59640;20902;80542;99101
2607307;PE;Ipubi;23042;13850;14270;17284;10836;28120;31515
2607406;PE;Itacuruba;3669;2132;2237;3708;661;4369;5013
2607505;PE;Itaíba;26799;13039;13225;9651;16613;26264;26268
2607604;PE;Ilha de Itamaracá;15858;12861;9588;17521;4928;22449;27076
2607653;PE;Itambé;34982;17484;17914;29424;5974;35398;36495
2607703;PE;Itapetim;14766;6852;7030;8427;5455;13882;13492
2607752;PE;Itapissuma;20116;11944;11779;18401;5322;23723;27144
2607802;PE;Itaquitinga;14950;7885;7813;12065;3633;15698;17056
2607901;PE;Jaboatão dos Guararapes;581556;304840;339859;630683;14016;644699;711330
2607950;PE;Jaqueira;11653;5719;5794;7089;4424;11513;11632
2608008;PE;Jataúba;14653;7848;7962;9181;6629;15810;17305
2608057;PE;Jatobá;13148;6847;7135;6097;7885;13982;14904
2608107;PE;João Alfredo;27023;14869;15866;15015;15720;30735;33570
2608206;PE;Joaquim Nabuco;15925;7902;7872;11507;4267;15774;15999
2608255;PE;Jucati;9695;5272;5332;2828;7776;10604;11545
2608305;PE;Jupi;12329;6686;7023;8360;5349;13709;15007
2608404;PE;Jurema;13741;7098;7396;8748;5746;14494;15483
2608453;PE;Lagoa do Carro;13110;7827;8163;11614;4376;15990;18429
2608503;PE;LAGOA DE ITAENGA;20172;10071;10582;17112;3541;20653;21490
2608602;PE;Lagoa do Ouro;10977;5959;6162;6018;6103;12121;13300
2608701;PE;Lagoa dos Gatos;16100;7825;7790;8641;6974;15615;16345
2608750;PE;Lagoa Grande;19137;11295;11424;10369;12350;22719;26090
2608800;PE;Lajedo;32209;17410;19196;26391;10215;36606;40883
2608909;PE;Limoeiro;56322;26870;28704;44691;10883;55574;56149
2609006;PE;Macaparana;22494;11661;12246;14817;9090;23907;25565
2609105;PE;Machados;9826;6565;7067;8481;5151;13632;16549
2609154;PE;Manari;13028;9197;8990;3844;14343;18187;22110
2609204;PE;Maraial;14017;6179;6078;8584;3673;12257;11098
2609303;PE;Mirandiba;13122;7116;7192;7141;7167;14308;15548
2609402;PE;Moreno;49205;27722;29045;50250;6517;56767;63792
2609501;PE;Nazaré da Mata;29254;14735;16047;27177;3605;30782;32673
2609600;PE;Olinda;367902;173654;201905;368119;7440;375559;393734
2609709;PE;Orobó;22475;11058;11807;8216;14649;22865;23985
2609808;PE;Orocó;10825;6561;6615;4614;8562;13176;15309
2609907;PE;Ouricuri;56733;31688;32647;32577;31758;64335;70466
2610004;PE;Palmares;55790;28802;30722;46880;12644;59524;63745
2610103;PE;Palmeirina;9536;3985;4203;5178;3010;8188;7509
2610202;PE;Panelas;25874;12595;13059;13966;11688;25654;26438
2610301;PE;Paranatama;10348;5506;5495;2238;8763;11001;11608
2610400;PE;Parnamirim;19289;10281;9946;8380;11847;20227;22198
2610509;PE;Passira;29132;14004;14660;13956;14708;28664;28856
2610608;PE;Paudalho;45138;25216;26158;36953;14421;51374;57346
2610707;PE;Paulista;262237;141718;158893;300611;0;300611;336919
2610806;PE;Pedra;20244;10475;10475;12008;8942;20950;22716
2610905;PE;Pesqueira;57721;30547;32246;45026;17767;62793;68067
2611002;PE;Petrolândia;27320;15945;16540;23615;8870;32485;37246
2611101;PE;Petrolina;218538;143283;150798;219309;74772;294081;359372
2611200;PE;Poção;11178;5375;5867;6988;4254;11242;11308
2611309;PE;Pombos;23351;11871;12162;16006;8027;24033;27204
2611408;PE;Primavera;11477;6882;6557;8579;4860;13439;15231
2611507;PE;Quipapá;22145;11929;12258;11834;12353;24187;26309
2611533;PE;Quixaba;6855;3322;3413;2491;4244;6735;6796
2611606;PE;Recife;1422905;709063;827871;1536934;0;1536934;1661017
2611705;PE;Riacho das Almas;18142;9414;9744;8779;10379;19158;20744
2611804;PE;Ribeirão;41449;21737;22708;34009;10436;44445;47813
2611903;PE;Rio Formoso;20764;11115;11025;13368;8772;22140;23719
2612000;PE;Sairé;13649;5534;5708;6305;4937;11242;9600
2612109;PE;Salgadinho;7139;4670;4617;3062;6225;9287;11214
2612208;PE;Salgueiro;51571;27611;29030;45718;10923;56641;61561
2612307;PE;Saloá;15006;7375;7908;7659;7624;15283;15880
2612406;PE;Sanharó;15879;10757;11203;12492;9468;21960;27308
2612455;PE;Santa Cruz;11264;6815;6779;4453;9141;13594;15713
2612471;PE;Santa Cruz da Baixa Verde;10893;5812;5957;5277;6492;11769;12708
2612505;PE;Santa Cruz do Capibaribe;59048;42335;45203;85562;1976;87538;111812
2612554;PE;Santa Filomena;12115;6725;6597;2226;11096;13322;14645
2612604;PE;Santa Maria da Boa Vista;36914;19865;19608;14861;24612;39473;42266
2612703;PE;Santa Maria do Cambucá;11739;6474;6549;3277;9746;13023;14308
2612802;PE;Santa Terezinha;10251;5385;5606;6876;4115;10991;11914
2612901;PE;São Benedito do Sul;10477;7015;6924;7156;6783;13939;16239
2613008;PE;São Bento do Una;45360;26568;26664;28007;25225;53232;60567
2613107;PE;São Caitano;33426;17209;18069;27081;8197;35278;37488
2613206;PE;São João;19744;10440;10865;9661;11644;21305;23002
2613305;PE;São Joaquim do Monte;19842;10197;10292;14122;6367;20489;21439
2613404;PE;São José da Coroa Grande;13971;8865;9307;13429;4743;18172;21868
2613503;PE;São José do Belmonte;31652;16243;16377;16168;16452;32620;34082
2613602;PE;São José do Egito;29468;15522;16316;20968;10870;31838;34210
2613701;PE;São Lourenço da Mata;90402;50032;52924;96812;6144;102956;114910
2613800;PE;São Vicente Ferrer;16004;8364;8636;11205;5795;17000;18150
2613909;PE;Serra Talhada;70912;37831;41410;61288;17953;79241;87467
2614006;PE;Serrita;17848;9199;9132;6356;11975;18331;19226
2614105;PE;Sertânia;31657;16480;17243;18548;15175;33723;36189
2614204;PE;Sirinhaém;33046;20350;19956;21473;18833;40306;46845
2614303;PE;Moreilândia;11116;5595;5542;6843;4294;11137;11269
2614402;PE;Solidão;5532;2902;2842;1831;3913;5744;6034
2614501;PE;Surubim;50331;27931;30513;44004;14440;58444;66192
2614600;PE;Tabira;24065;12969;13461;19772;6658;26430;28860
2614709;PE;Tacaimbó;12929;6261;6443;7076;5628;12704;12843
2614808;PE;Tacaratu;17096;11162;10911;9197;12876;22073;26439
2614857;PE;Tamandaré;17281;10425;10320;15186;5559;20745;23852
2615003;PE;Taquaritinga do Norte;19757;12348;12575;17977;6946;24923;29472
2615102;PE;Terezinha;6300;3271;3466;2860;3877;6737;7227
2615201;PE;Terra Nova;7518;4702;4554;5015;4241;9256;10314
2615300;PE;Timbaúba;56906;25906;27917;46371;7452;53823;52587
2615409;PE;Toritama;21800;17473;18158;34198;1433;35631;47088
2615508;PE;Tracunhaém;12394;6363;6692;10969;2086;13055;13856
2615607;PE;Trindade;21930;12889;13227;22463;3653;26116;31103
2615706;PE;Triunfo;15135;7180;7826;7944;7062;15006;15232
2615805;PE;Tupanatinga;20801;12022;12232;8496;15758;24254;27793
2615904;PE;Tuparetama;7766;3852;4073;6351;1574;7925;8266
2616001;PE;Venturosa;13462;7869;8195;10351;5713;16064;18835
2616100;PE;Verdejante;8846;4484;4658;2692;6450;9142;9572
2616183;PE;Vertente do Lério;8536;3878;4016;1813;6081;7894;7526
2616209;PE;Vertentes;14957;8976;9291;12978;5289;18267;21172
2616308;PE;Vicência;28820;15194;15537;13805;16926;30731;32897
2616407;PE;Vitória de Santo Antão;117609;62685;67855;113481;17059;130540;140389
2616506;PE;Xexéu;13597;6996;7096;9165;4927;14092;14789
2700102;AL;Água Branca;18660;9650;9726;5100;14276;19376;20263
2700201;AL;Anadia;17849;8563;8860;8950;8473;17423;17507
2700300;AL;Arapiraca;186466;101901;112166;181562;32505;214067;234309
2700409;AL;Atalaia;40552;22230;22149;22451;21928;44379;47540
2700508;AL;Barra de Santo Antônio;11351;7076;7152;13240;988;14228;16201
2700607;AL;Barra de São Miguel;6379;3765;3808;6521;1052;7573;8434
2700706;AL;Batalha;14799;8386;8690;12042;5034;17076;18440
2700805;AL;Belém;5919;2222;2329;1872;2679;4551;4226
2700904;AL;Belo Monte;6822;3551;3481;1171;5861;7032;6717
2701001;AL;Boca da Mata;24227;12772;13008;17455;8325;25780;27429
2701100;AL;Branquinha;11325;5379;5207;6673;3913;10586;10426
2701209;AL;Cacimbinhas;9552;5049;5148;5404;4793;10197;10920
2701308;AL;Cajueiro;18975;10078;10332;16485;3925;20410;21397
2701357;AL;Campestre;6223;3291;3308;5541;1058;6599;6972
2701407;AL;Campo Alegre;41028;25031;25800;22170;28661;50831;57997
2701506;AL;Campo Grande;9134;4436;4596;4185;4847;9032;9576
2701605;AL;Canapi;17334;8661;8587;5538;11710;17248;17715
2701704;AL;Capela;18693;8430;8647;12650;4427;17077;16907
2701803;AL;Carneiros;6585;4058;4232;4702;3588;8290;9568
2701902;AL;Chã Preta;7760;3644;3502;4488;2658;7146;7311
2702009;AL;Coité do Nóia;11993;5421;5505;3737;7189;10926;10594
2702108;AL;Colônia Leopoldina;17493;10073;9949;15319;4703;20022;21935
2702207;AL;Coqueiro Seco;5134;2758;2765;4970;553;5523;5882
2702306;AL;Coruripe;48846;25761;26399;46073;6087;52160;57647
2702355;AL;Craíbas;20789;11155;11488;7331;15312;22643;24396
2702405;AL;Delmiro Gouveia;42995;23053;25037;34849;13241;48090;52501
2702504;AL;Dois Riachos;11066;5454;5425;5084;5795;10879;11059
2702553;AL;Estrela de Alagoas;16341;8398;8856;4031;13223;17254;18304
2702603;AL;Feira Grande;21270;10562;10763;3425;17900;21325;22192
2702702;AL;Feliz Deserto;3836;2125;2207;3468;864;4332;4803
2702801;AL;Flexeiras;11979;6247;6092;8023;4316;12339;12823
2702900;AL;Girau do Ponciano;29574;18176;18449;11298;25327;36625;41549
2703007;AL;Ibateguara;15105;7555;7578;9336;5797;15133;15637
2703106;AL;Igaci;25584;12275;12922;6193;19004;25197;25596
2703205;AL;Igreja Nova;21451;11750;11548;4776;18522;23298;24670
2703304;AL;Inhapi;17768;8813;9089;6699;11203;17902;18398
2703403;AL;Jacaré dos Homens;5720;2671;2742;3032;2381;5413;5185
2703502;AL;Jacuípe;7313;3580;3406;4344;2642;6986;6992
2703601;AL;Japaratinga;6868;3871;3881;3305;4447;7752;8444
2703700;AL;Jaramataia;5788;2807;2755;2917;2645;5562;5751
2703759;AL;Jequiá da Praia;0;6131;5904;2879;9156;12035;11495
2703809;AL;Joaquim Gomes;21488;11535;11046;14483;8098;22581;24167
2703908;AL;Jundiá;4680;2126;2076;2827;1375;4202;4119
2704005;AL;Junqueiro;23832;11754;12100;7819;16035;23854;24716
2704104;AL;Lagoa da Canoa;19988;8973;9280;9165;9088;18253;17692
2704203;AL;Limoeiro de Anadia;24263;13424;13568;2246;24746;26992;28904
2704302;AL;Maceió;797759;436405;496203;931984;624;932608;1031597
2704401;AL;Major Isidoro;17639;9269;9632;9310;9591;18901;19923
2704500;AL;Maragogi;21832;14515;14231;18622;10124;28746;33351
2704609;AL;Maravilha;13687;5195;5081;5129;5147;10276;8850
2704708;AL;Marechal Deodoro;35866;22705;23289;43406;2588;45994;52848
2704807;AL;Maribondo;15145;6534;7080;9977;3637;13614;13123
2704906;AL;Mar Vermelho;4078;1821;1831;1638;2014;3652;3474
2705002;AL;Mata Grande;25032;12338;12364;5676;19026;24702;25200
2705101;AL;Matriz de Camaragibe;24017;11589;12191;22095;1685;23780;24627
2705200;AL;Messias;11990;7703;7979;14263;1419;15682;18201
2705309;AL;Minador do Negrão;5399;2618;2662;2252;3028;5280;5315
2705408;AL;Monteirópolis;7240;3359;3585;2518;4426;6944;7171
2705507;AL;Murici;24671;13276;13430;22104;4602;26706;28428
2705606;AL;Novo Lino;10375;6122;5947;7337;4732;12069;12837
2705705;AL;Olho dÁgua das Flores;19417;9723;10644;13992;6375;20367;21690
2705804;AL;Olho dÁgua do Casado;7059;4276;4215;4027;4464;8491;9507
2705903;AL;Olho dÁgua Grande;4847;2463;2494;1203;3754;4957;5133
2706000;AL;Olivença;10369;5566;5491;3147;7910;11057;11681
2706109;AL;Ouro Branco;10077;5438;5473;6873;4038;10911;11573
2706208;AL;Palestina;4523;2474;2638;3237;1875;5112;5061
2706307;AL;Palmeira dos Índios;68060;33621;36813;51655;18779;70434;73452
2706406;AL;Pão de Açúcar;24351;11754;12055;10772;13037;23809;24307
2706422;AL;Pariconha;10086;5107;5139;2796;7450;10246;10546
2706448;AL;Paripueira;8049;5592;5757;10051;1298;11349;13484
2706505;AL;Passo de Camaragibe;13755;7510;7262;7239;7533;14772;15270
2706604;AL;Paulo Jacinto;7485;3631;3795;4908;2518;7426;7556
2706703;AL;Penedo;56993;29310;31079;45011;15378;60389;64005
2706802;AL;Piaçabuçu;16775;8626;8593;10452;6767;17219;17868
2706901;AL;Pilar;31201;16172;17140;31808;1504;33312;35310
2707008;AL;Pindoba;2926;1420;1446;1637;1229;2866;2903
2707107;AL;Piranhas;20007;11301;11751;13191;9861;23052;25324
2707206;AL;Poço das Trincheiras;13222;7003;6870;2043;11830;13873;14447
2707305;AL;Porto Calvo;23951;12761;12957;20220;5498;25718;27331
2707404;AL;Porto de Pedras;10238;4264;4155;4796;3623;8419;7618
2707503;AL;Porto Real do Colégio;18355;9590;9724;6582;12732;19314;20158
2707602;AL;Quebrangulo;11902;5673;5813;6474;5012;11486;11202
2707701;AL;Rio Largo;62510;33337;35175;55968;12544;68512;75662
2707800;AL;Roteiro;6985;3369;3287;5830;826;6656;6634
2707909;AL;Santa Luzia do Norte;6388;3371;3522;6174;719;6893;7344
2708006;AL;Santana do Ipanema;41485;21822;23127;27201;17748;44949;47910
2708105;AL;Santana do Mundaú;11534;5490;5471;5658;5303;10961;10637
2708204;AL;São Brás;6551;3340;3380;3183;3537;6720;6977
2708303;AL;São José da Laje;21071;11174;11515;15390;7299;22689;24064
2708402;AL;São José da Tapera;27562;14870;15270;11661;18479;30140;32462
2708501;AL;São Luís do Quitunde;29543;16327;16089;20597;11819;32416;34825
2708600;AL;São Miguel dos Campos;51456;26577;28014;52571;2020;54591;62328
2708709;AL;São Miguel dos Milagres;5860;3566;3604;2256;4914;7170;8073
2708808;AL;São Sebastião;29124;15852;16155;12306;19701;32007;34424
2708907;AL;Satuba;12555;7111;7493;12793;1811;14604;14042
2708956;AL;Senador Rui Palmeira;11979;6405;6642;3944;9103;13047;13893
2709004;AL;Tanque dArca;6594;3020;3102;2140;3982;6122;6115
2709103;AL;Taquarana;17046;9237;9783;7314;11706;19020;20162
2709152;AL;Teotônio Vilela;36881;20168;20990;34789;6369;41158;44570
2709202;AL;Traipu;23439;12953;12757;8035;17675;25710;27934
2709301;AL;União dos Palmares;58620;30193;32208;47691;14710;62401;65963
2709400;AL;Viçosa;26263;12420;13024;18336;7108;25444;25655
2800100;SE;Amparo de São Francisco;2182;1135;1140;1840;435;2275;2386
2800209;SE;Aquidabã;18344;9808;10258;11460;8606;20066;21796
2800308;SE;Aracaju;461534;265321;305616;570937;0;570937;672614
2800407;SE;Arauá;9762;4887;4812;4486;5213;9699;9840
2800506;SE;Areia Branca;14824;8511;8371;8191;8691;16882;18825
2800605;SE;Barra dos Coqueiros;17807;12221;12791;20895;4117;25012;31439
2800670;SE;Boquim;24188;12532;12996;15998;9530;25528;26980
2800704;SE;Brejo Grande;7102;3938;3807;4022;3723;7745;8396
2801009;SE;Campo do Brito;15175;8212;8554;8334;8432;16766;18325
2801108;SE;Canhoba;3965;2062;1885;1499;2448;3947;4003
2801207;SE;Canindé de São Francisco;17754;12293;12400;14067;10626;24693;30894
2801306;SE;Capela;26518;15272;15497;19752;11017;30769;34808
2801405;SE;Carira;17770;9965;10025;11151;8839;19990;22393
2801504;SE;Carmópolis;9352;6671;6829;10701;2799;13500;17232
2801603;SE;Cedro de São João;5378;2780;2853;5035;598;5633;5929
2801702;SE;Cristinápolis;14268;8295;8224;8336;8183;16519;18181
2801900;SE;Cumbe;3646;1903;1910;2271;1542;3813;4008
2802007;SE;Divina Pastora;3266;2189;2137;2099;2227;4326;5290
2802106;SE;Estância;59002;31415;33049;54796;9668;64464;69919
2802205;SE;Feira Nova;5068;2630;2695;3588;1737;5325;5617
2802304;SE;Frei Paulo;11973;6777;7077;8204;5650;13854;15688
2802403;SE;Gararu;11363;5849;5609;2831;8627;11458;11599
2802502;SE;General Maynard;2400;1417;1497;1843;1071;2914;3421
2802601;SE;Gracho Cardoso;5519;2891;2757;2706;2942;5648;5831
2802700;SE;Ilha das Flores;8281;4168;4180;5435;2913;8348;8522
2802809;SE;Indiaroba;13152;8049;7812;5585;10276;15861;18337
2802908;SE;Itabaiana;76813;42514;44467;67717;19264;86981;96839
2803005;SE;Itabaianinha;35454;19373;19513;19390;19496;38886;42399
2803104;SE;Itabi;5174;2478;2494;2752;2220;4972;4869
2803203;SE;Itaporanga dAjuda;25482;15164;15264;11872;18556;30428;35054
2803302;SE;Japaratuba;14556;8386;8488;7916;8958;16874;19067
2803401;SE;Japoatã;13020;6481;6466;4309;8638;12947;13422
2803500;SE;Lagarto;83334;46498;48354;48889;45963;94852;106015
2803609;SE;Laranjeiras;23560;13138;13765;21258;5645;26903;30327
2803708;SE;Macambira;5802;3168;3243;3069;3342;6411;7002
2803807;SE;Malhada dos Bois;3208;1755;1706;1600;1861;3461;3715
2803906;SE;Malhador;11481;6085;5971;5626;6430;12056;12689
2804003;SE;Maruim;15454;8015;8323;12045;4293;16338;17328
2804102;SE;Moita Bonita;10758;5478;5556;4618;6416;11034;11361
2804201;SE;Monte Alegre de Sergipe;11587;6890;6731;8045;5576;13621;15315
2804300;SE;Muribeca;7101;3683;3659;3288;4054;7342;7653
2804409;SE;Neópolis;18593;9238;9273;10519;7992;18511;18688
2804458;SE;Nossa Senhora Aparecida;8279;4255;4255;3457;5053;8510;8822
2804508;SE;Nossa Senhora da Glória;26910;16085;16429;21633;10881;32514;37715
2804607;SE;Nossa Senhora das Dores;22195;12128;12451;16027;8552;24579;26957
2804706;SE;Nossa Senhora de Lourdes;6023;3153;3089;3290;2952;6242;6509
2804805;SE;Nossa Senhora do Socorro;131679;78314;82515;155836;4993;160829;187733
2804904;SE;Pacatuba;11536;6687;6450;2688;10449;13137;14650
2805000;SE;Pedra Mole;2630;1497;1471;1192;1776;2968;3309
2805109;SE;Pedrinhas;7929;4346;4475;6464;2357;8821;9727
2805208;SE;Pinhão;5244;2925;3048;3319;2654;5973;6678
2805307;SE;Pirambu;7255;4212;4157;4906;3463;8369;9436
2805406;SE;Poço Redondo;26022;15766;15111;8536;22341;30877;35461
2805505;SE;Poço Verde;19973;10865;11103;12306;9662;21968;24003
2805604;SE;Porto da Folha;25664;13876;13248;9929;17195;27124;28788
2805703;SE;Propriá;27385;13850;14607;24393;4064;28457;29756
2805802;SE;Riachão do Dantas;19202;9732;9662;4872;14522;19394;19813
2805901;SE;Riachuelo;8337;4550;4801;7851;1500;9351;10354
2806008;SE;Ribeirópolis;15439;8488;8675;11916;5247;17163;18891
2806107;SE;Rosário do Catete;7102;4447;4775;6504;2718;9222;11158
2806206;SE;Salgado;18876;9658;9704;6691;12671;19362;20051
2806305;SE;Santa Luzia do Itanhy;13948;7141;6773;2915;10999;13914;14205
2806404;SE;Santana do São Francisco;6135;3540;3498;4523;2515;7038;7906
2806503;SE;Santa Rosa de Lima;3595;1889;1863;2137;1615;3752;3933
2806602;SE;Santo Amaro das Brotas;10670;5604;5785;8202;3187;11389;12200
2806701;SE;São Cristóvão;64647;38404;40472;66682;12194;78876;92090
2806800;SE;São Domingos;9260;5081;5176;5141;5116;10257;11276
2806909;SE;São Francisco;2532;1708;1687;2379;1016;3395;3837
2807006;SE;São Miguel do Aleixo;3447;1843;1859;1751;1951;3702;3964
2807105;SE;Simão Dias;36813;18890;19834;20449;18275;38724;40724
2807204;SE;Siriri;6914;3990;4016;3183;4823;8006;9046
2807303;SE;Telha;2638;1476;1481;1127;1830;2957;3271
2807402;SE;Tobias Barreto;43172;23464;24575;32223;15816;48039;52861
2807501;SE;Tomar do Geru;12840;6540;6333;4814;8059;12873;13534
2807600;SE;Umbaúba;19214;11110;11550;13932;8728;22660;25800
2900108;BA;Abaíra;9067;4088;4236;3744;4580;8324;8681
2900207;BA;Abaré;13648;8566;8506;9035;8037;17072;20594
2900306;BA;Acajutiba;14322;7300;7530;12786;2044;14830;15214
2900355;BA;Adustina;14302;7908;7798;5574;10132;15706;17209
2900405;BA;Água Fria;14718;7903;7823;5777;9949;15726;17096
2900504;BA;Érico Cardoso;12160;5421;5434;2016;8839;10855;10513
2900603;BA;Aiquara;5315;2351;2251;2680;1922;4602;4387
2900702;BA;Alagoinhas;130095;67381;74779;124245;17915;142160;153023
2900801;BA;Alcobaça;20900;10842;10477;11112;10207;21319;22509
2900900;BA;Almadina;7862;3202;3158;5080;1280;6360;5273
2901007;BA;Amargosa;31108;16634;17706;24895;9445;34340;37631
2901106;BA;Amélia Rodrigues;24134;12283;12907;19957;5233;25190;24997
2901155;BA;América Dourada;15959;8071;7881;10845;5107;15952;16086
2901205;BA;Anagé;31060;12878;12622;4927;20573;25500;21229
2901304;BA;Andaraí;13884;7170;6778;7770;6178;13948;13122
2901353;BA;Andorinha;15774;7331;7086;6213;8204;14417;14416
2901403;BA;Angical;14701;7460;6613;6531;7542;14073;13902
2901502;BA;Anguera;8834;5086;5162;4326;5922;10248;11369
2901601;BA;Antas;14059;8587;8491;6359;10719;17078;19659
2901700;BA;Antônio Cardoso;11620;5729;5819;3225;8323;11548;11670
2901809;BA;Antônio Gonçalves;9716;5576;5443;5783;5236;11019;11955
2901908;BA;Aporá;16769;8951;8769;8487;9233;17720;17840
2901957;BA;Apuarema;7443;3796;3667;5121;2342;7463;7274
2902005;BA;Aracatu;15491;7045;6687;3928;9804;13732;12960
2902054;BA;Araças;11003;5832;5737;5808;5761;11569;12237
2902104;BA;Araci;47584;25929;25707;19637;31999;51636;54903
2902203;BA;Aramari;9258;5001;5038;5125;4914;10039;11519
2902252;BA;Arataca;11218;5502;4901;5604;4799;10403;10904
2902302;BA;Aratuípe;8381;4373;4217;5508;3082;8590;8848
2902401;BA;Aurelino Leal;17149;6836;6763;11430;2169;13599;11079
2902500;BA;Baianópolis;12179;7167;6696;3495;10368;13863;13979
2902609;BA;Baixa Grande;20441;9969;10100;8333;11736;20069;20431
2902658;BA;Banzaê;11156;5992;5819;4039;7772;11811;13251
2902708;BA;Barra;44203;25172;24170;22461;26881;49342;54225
2902807;BA;Barra da Estiva;24440;10655;10535;10406;10784;21190;20198
2902906;BA;Barra do Choça;40818;17553;17235;22407;12381;34788;30831
2903003;BA;Barra do Mendes;13610;7016;6981;6255;7742;13997;13128
2903102;BA;Barra do Rocha;8074;3350;2986;3814;2522;6336;5515
2903201;BA;Barreiras;131849;67892;69536;123734;13694;137428;158432
2903235;BA;Barro Alto;12098;6917;6709;6726;6900;13626;15171
2903276;BA;Barrocas;0;7214;6975;5693;8496;14189;16225
2903300;BA;Barro Preto;8602;3306;3147;5295;1158;6453;5312
2903409;BA;Belmonte;20032;11174;10664;11426;10412;21838;23540
2903508;BA;Belo Campo;17655;8125;7901;9036;6990;16026;17013
2903607;BA;Biritinga;14641;7558;7275;3517;11316;14833;15989
2903706;BA;Boa Nova;20544;7821;7588;5808;9601;15409;12039
2903805;BA;Boa Vista do Tupim;18408;9142;8858;6593;11407;18000;18491
2903904;BA;Bom Jesus da Lapa;54421;31686;31822;43111;20397;63508;70151
2903953;BA;Bom Jesus da Serra;10502;5194;4929;2770;7353;10123;9768
2904001;BA;Boninal;12461;6702;6993;4607;9088;13695;14518
2904050;BA;Bonito;12902;7535;7316;6246;8605;14851;16999
2904100;BA;Boquira;22121;10861;11181;7361;14681;22042;21486
2904209;BA;Botuporã;11522;5614;5548;4076;7086;11162;10050
2904308;BA;Brejões;15344;7114;7168;4937;9345;14282;14155
2904407;BA;Brejolândia;8762;5811;5316;1984;9143;11127;10675
2904506;BA;Brotas de Macaúbas;13003;5473;5245;3118;7600;10718;10705
2904605;BA;Brumado;61670;31733;32817;45119;19431;64550;67468
2904704;BA;Buerarema;19118;9310;9312;15299;3323;18622;18269
2904753;BA;Buritirama;17797;10202;9387;7892;11697;19589;21374
2904803;BA;Caatiba;15508;6010;5438;5405;6043;11448;6232
2904852;BA;Cabaceiras do Paraguaçu;15547;8549;8778;4644;12683;17327;19010
2904902;BA;Cachoeira;30416;15460;16575;16392;15643;32035;33659
2905008;BA;Caculé;20339;11147;11084;13313;8918;22231;23407
2905107;BA;Caém;12563;5150;5226;3658;6718;10376;8912
2905156;BA;Caetanos;13076;7067;6599;3300;10366;13666;14671
2905206;BA;Caetité;45090;23422;24102;28456;19068;47524;51184
2905305;BA;Cafarnaum;16059;8771;8441;10559;6653;17212;18585
2905404;BA;Cairu;11410;7838;7528;8144;7222;15366;18666
2905503;BA;Caldeirão Grande;11395;6152;6333;4558;7927;12485;13452
2905602;BA;Camacan;31055;15726;15742;24682;6786;31468;32023
2905701;BA;Camaçari;161727;120626;122358;232045;10939;242984;309208
2905800;BA;Camamu;33661;17897;17263;15616;19544;35160;35444
2905909;BA;Campo Alegre de Lourdes;27607;14142;13949;8126;19965;28091;28839
2906006;BA;Campo Formoso;61942;33475;33163;24872;41766;66638;71754
2906105;BA;Canápolis;9743;4794;4588;3225;6157;9382;9694
2906204;BA;Canarana;21665;12109;11946;11463;12592;24055;26468
2906303;BA;Canavieiras;35322;16080;16251;25901;6430;32331;30722
2906402;BA;Candeal;10121;4499;4396;3476;5419;8895;8109
2906501;BA;Candeias;76783;40269;42808;75917;7160;83077;87820
2906600;BA;Candiba;12124;6813;6392;7725;5480;13205;14415
2906709;BA;Cândido Sales;28516;14025;13891;19293;8623;27916;24921
2906808;BA;Cansanção;31947;16568;16355;11025;21898;32923;34929
2906824;BA;Canudos;13761;8012;7743;8716;7039;15755;16832
2906857;BA;Capela do Alto Alegre;11898;5808;5719;5595;5932;11527;11597
2906873;BA;Capim Grosso;23908;12984;13545;21725;4804;26529;31055
2906899;BA;Caraíbas;17164;5216;5009;2512;7713;10225;8659
2906907;BA;Caravelas;20103;10878;10559;11317;10120;21437;22166
2907004;BA;Cardeal da Silva;8034;4166;4105;2902;5369;8271;9395
2907103;BA;Carinhanha;27272;14518;13860;12580;15798;28378;29118
2907202;BA;Casa Nova;55730;33094;31850;37555;27389;64944;73092
2907301;BA;Castro Alves;25561;12272;13147;15700;9719;25419;26369
2907400;BA;Catolândia;3092;1353;1256;966;1643;2609;3619
2907509;BA;Catu;46731;24820;26255;42747;8328;51075;55222
2907558;BA;Caturama;8640;4545;4302;2373;6474;8847;9303
2907608;BA;Central;16792;8699;8328;8165;8862;17027;17293
2907707;BA;Chorrochó;10171;5442;5292;2631;8103;10734;11221
2907806;BA;Cícero Dantas;30934;15862;16442;17726;14578;32304;32636
2907905;BA;Cipó;14285;7675;8089;11291;4473;15764;17402
2908002;BA;Coaraci;27852;10275;10689;19134;1830;20964;16128
2908101;BA;Cocos;17611;9316;8866;8572;9610;18182;18835
2908200;BA;Conceição da Feira;17514;9925;10483;13154;7254;20408;22933
2908309;BA;Conceição do Almeida;18912;8706;9189;7926;9969;17895;17087
2908408;BA;Conceição do Coité;56317;30704;31338;36279;25763;62042;67394
2908507;BA;Conceição do Jacuípe;26194;14564;15559;23542;6581;30123;33631
2908606;BA;Conde;20426;11831;11763;12110;11484;23594;26223
2908705;BA;Condeúba;18047;8265;8623;7453;9435;16888;17113
2908804;BA;Contendas do Sincorá;4264;2383;2280;2297;2366;4663;4025
2908903;BA;Coração de Maria;23818;10858;11573;9405;13026;22431;22391
2909000;BA;Cordeiros;8193;4048;4121;2551;5618;8169;8667
2909109;BA;Coribe;15148;7196;7105;6141;8160;14301;14108
2909208;BA;Coronel João Sá;19665;8796;8270;7043;10023;17066;15549
2909307;BA;Correntina;30583;15763;15496;12611;18648;31259;32243
2909406;BA;Cotegipe;13374;7116;6522;6651;6987;13638;13756
2909505;BA;Cravolândia;5001;2554;2488;3180;1862;5042;5352
2909604;BA;Crisópolis;19037;10235;9821;8625;11431;20056;21219
2909703;BA;Cristópolis;12662;6869;6411;3133;10147;13280;13981
2909802;BA;Cruz das Almas;53049;27664;30920;49879;8705;58584;63923
2909901;BA;Curaçá;28841;16453;15712;13720;18445;32165;35065
2910008;BA;Dário Meira;15222;6729;6112;5090;7751;12841;10347
2910057;BA;Dias dÁvila;45333;32802;33571;62417;3956;66373;83705
2910107;BA;Dom Basílio;10427;5867;5488;2241;9114;11355;12281
2910206;BA;Dom Macedo Costa;3748;1896;1977;1760;2113;3873;4072
2910305;BA;Elísio Medrado;7860;3953;3999;3253;4699;7952;8129
2910404;BA;Encruzilhada;32924;12387;11399;5135;18651;23786;15914
2910503;BA;Entre Rios;37513;19642;20241;23844;16039;39883;42014
2910602;BA;Esplanada;27230;16574;16704;20826;12452;33278;37902
2910701;BA;Euclides da Cunha;53885;28329;27983;27420;28892;56312;61112
2910727;BA;Eunápolis;84120;49423;50823;93442;6804;100246;115360
2910750;BA;Fátima;18298;8950;8702;6911;10741;17652;17801
2910776;BA;Feira da Mata;6235;3186;2993;3243;2936;6179;5656
2910800;BA;Feira de Santana;480949;264031;292725;510736;46020;556756;624107
2910859;BA;Filadélfia;17194;8442;8307;9031;7718;16749;16314
2910909;BA;Firmino Alves;5170;2733;2652;4338;1047;5385;5641
2911006;BA;Floresta Azul;11614;5438;5222;7343;3317;10660;10525
2911105;BA;Formosa do Rio Preto;18288;11669;10865;13647;8887;22534;26111
2911204;BA;Gandu;27160;15100;15229;24840;5489;30329;32778
2911253;BA;Gavião;4792;2356;2205;2538;2023;4561;4417
2911303;BA;Gentio do Ouro;10173;5499;5221;5404;5316;10720;11284
2911402;BA;Glória;14559;7531;7542;2827;12246;15073;15247
2911501;BA;Gongogi;10522;4227;4117;5359;2985;8344;6852
2911600;BA;Governador Mangabeira;17165;9504;10322;7417;12409;19826;20800
2911659;BA;Guajeru;12836;5233;5150;2079;8304;10383;6371
2911709;BA;Guanambi;71728;38462;40339;62534;16267;78801;85353
2911808;BA;Guaratinga;24319;11633;10562;10453;11742;22195;20565
2911857;BA;Heliópolis;13108;6285;6159;5429;7015;12444;12946
2911907;BA;Iaçu;28501;12628;13107;20166;5569;25735;23950
2912004;BA;Ibiassucê;12828;5109;4968;4698;5379;10077;8849
2912103;BA;Ibicaraí;28861;11865;12376;17853;6388;24241;21083
2912202;BA;Ibicoara;14453;8763;8538;10980;6321;17301;19990
2912301;BA;Ibicuí;15129;8064;7722;11965;3821;15786;16262
2912400;BA;Ibipeba;15362;8776;8245;10055;6966;17021;18421
2912509;BA;Ibipitanga;13419;7048;7123;5155;9016;14171;14989
2912608;BA;Ibiquera;4495;2530;2335;2461;2404;4865;4047
2912707;BA;Ibirapitanga;22177;11535;11075;6163;16447;22610;23433
2912806;BA;Ibirapuã;7096;4105;3855;4534;3426;7960;8740
2912905;BA;Ibirataia;24741;9445;9501;15751;3195;18946;14476
2913002;BA;Ibitiara;14443;7701;7818;3437;12082;15519;16463
2913101;BA;Ibititá;17905;9050;8782;8341;9491;17832;17048
2913200;BA;Ibotirama;24149;12803;12619;19499;5923;25422;27076
2913309;BA;Ichu;5593;2588;2667;3365;1890;5255;6232
2913408;BA;Igaporã;14557;7640;7554;7860;7334;15194;15661
2913457;BA;Igrapiúna;14960;7049;6298;4277;9070;13347;12963
2913507;BA;Iguaí;25134;13122;12602;14608;11116;25724;27006
2913606;BA;Ilhéus;222127;89363;94868;155300;28931;184231;157639
2913705;BA;Inhambupe;29589;18021;18269;15647;20643;36290;40720
2913804;BA;Ipecaetá;18383;7587;7747;2637;12697;15334;14229
2913903;BA;Ipiaú;43621;21842;22588;40424;4006;44430;45969
2914000;BA;Ipirá;61746;29089;30263;29027;30325;59352;59281
2914109;BA;Ipupiara;8541;4743;4547;5984;3306;9290;9954
2914208;BA;Irajuba;6362;3506;3496;3273;3729;7002;7295
2914307;BA;Iramaia;17553;6165;5823;5402;6586;11988;7874
2914406;BA;Iraquara;18334;11249;11358;6758;15849;22607;25728
2914505;BA;Irará;25163;13315;14177;11252;16240;27492;29305
2914604;BA;Irecê;57436;32142;34262;61248;5156;66404;74050
2914653;BA;Itabela;25746;14481;13918;21387;7012;28399;30901
2914703;BA;Itaberaba;58943;29925;31698;48470;13153;61623;64795
2914802;BA;Itabuna;196675;96936;107774;199668;5042;204710;214123
2914901;BA;Itacaré;18120;12705;11635;13670;10670;24340;29051
2915007;BA;Itaeté;14006;7518;7414;6213;8719;14932;16164
2915106;BA;Itagi;14629;6589;6464;10210;2843;13053;12140
2915205;BA;Itagibá;17191;7812;7398;9583;5627;15210;14331
2915304;BA;Itagimirim;7728;3560;3550;5649;1461;7110;6784
2915353;BA;Itaguaçu da Bahia;11309;6959;6250;2598;10611;13209;14650
2915403;BA;Itaju do Colônia;8580;3683;3595;5845;1433;7278;6515
2915502;BA;Itajuípe;22511;10464;10630;16847;4247;21094;20309
2915601;BA;Itamaraju;64144;31610;31745;50176;13179;63355;64423
2915700;BA;Itamari;8347;4037;3867;5839;2065;7904;7971
2915809;BA;Itambé;30850;11591;11515;19714;3392;23106;22474
2915908;BA;Itanagra;6370;3881;3710;2327;5264;7591;6433
2916005;BA;Itanhém;21334;10292;9907;14204;5995;20199;19231
2916104;BA;Itaparica;18945;10175;10585;20760;0;20760;22440
2916203;BA;Itapé;14639;5603;5383;7188;3798;10986;8300
2916302;BA;Itapebi;11126;5257;5240;8271;2226;10497;10173
2916401;BA;Itapetinga;57931;33480;34834;66329;1985;68314;77408
2916500;BA;Itapicuru;27315;16473;15805;6675;25603;32278;36173
2916609;BA;Itapitanga;10382;5178;5029;7591;2616;10207;10284
2916708;BA;Itaquara;7861;3842;3836;4608;3070;7678;8375
2916807;BA;Itarantim;16923;9527;9021;15311;3237;18548;19937
2916856;BA;Itatim;12700;7259;7280;10113;4426;14539;14588
2916906;BA;Itiruçu;13585;6241;6452;9526;3167;12693;12482
2917003;BA;Itiúba;35543;18318;17794;9698;26414;36112;36140
2917102;BA;Itororó;19799;9998;9913;18099;1812;19911;20394
2917201;BA;Ituaçu;17268;9031;9096;6569;11558;18127;19095
2917300;BA;Ituberá;24133;13393;13199;19243;7349;26592;28870
2917334;BA;Iuiú;10489;5652;5253;5284;5621;10905;11038
2917359;BA;Jaborandi;10288;4660;4316;3041;5935;8976;8176
2917409;BA;Jacaraci;13520;6931;6725;4927;8729;13656;14855
2917508;BA;Jacobina;76492;38352;40933;55887;23398;79285;80749
2917607;BA;Jaguaquara;46621;25043;25976;38858;12161;51019;54913
2917706;BA;Jaguarari;27412;15423;14919;16624;13718;30342;33915
2917805;BA;Jaguaripe;13422;8450;8017;5300;11167;16467;19162
2917904;BA;Jandaíra;10027;5303;5019;6139;4183;10322;10742
2918001;BA;Jequié;147202;73628;78293;139452;12469;151921;156277
2918100;BA;Jeremoabo;34916;18998;18663;17443;20218;37661;40832
2918209;BA;Jiquiriçá;13638;7135;6952;5581;8506;14087;14576
2918308;BA;Jitaúna;21056;7124;6991;9260;4855;14115;10470
2918357;BA;João Dourado;18967;11275;11084;13566;8793;22359;25606
2918407;BA;Juazeiro;174567;97097;100887;160786;37198;197984;219544
2918456;BA;Jucuruçu;12377;5246;4714;2292;7668;9960;8856
2918506;BA;Jussara;15339;7814;7239;10052;5001;15053;15241
2918555;BA;Jussari;7556;3274;3193;4876;1591;6467;5706
2918605;BA;Jussiape;10051;3885;4087;3063;4909;7972;5777
2918704;BA;Lafaiete Coutinho;4102;2030;1871;2104;1797;3901;3663
2918753;BA;Lagoa Real;12765;7180;6754;2800;11134;13934;15870
2918803;BA;Laje;19601;11288;10918;6082;16124;22206;24214
2918902;BA;Lajedão;3409;1837;1896;2076;1657;3733;3993
2919009;BA;Lajedinho;4352;2043;1887;1245;2685;3930;3735
2919058;BA;Lajedo do Tabocal;8100;4187;4118;5149;3156;8305;8591
2919108;BA;Lamarão;9523;4483;4544;2087;6940;9027;8078
2919157;BA;Lapão;24727;13084;12567;10053;15598;25651;27323
2919207;BA;Lauro de Freitas;113543;79234;84180;163414;0;163414;204669
2919306;BA;Lençóis;8910;5210;5158;8037;2331;10368;11586
2919405;BA;Licínio de Almeida;12349;6277;6043;6264;6056;12320;12357
2919504;BA;Livramento de Nossa Senhora;38025;21490;21215;20546;22159;42705;46372
2919553;BA;Luís Eduardo Magalhães;0;31090;29089;54955;5224;60179;92671
2919603;BA;Macajuba;11474;5520;5709;6871;4358;11229;11318
2919702;BA;Macarani;14594;8581;8507;13631;3457;17088;19056
2919801;BA;Macaúbas;41806;23541;23526;15410;31657;47067;50481
2919900;BA;Macururé;8612;4001;4066;2859;5208;8067;7752
2919926;BA;Madre de Deus;12036;8381;9003;16861;523;17384;21754
2919959;BA;Maetinga;13686;3579;3452;2817;4214;7031;2386
2920007;BA;Maiquinique;7326;4544;4238;6916;1866;8782;10294
2920106;BA;Mairi;20085;9549;9786;11121;8214;19335;18535
2920205;BA;Malhada;15614;8285;7723;6559;9449;16008;16875
2920304;BA;Malhada de Pedras;8426;4316;4136;3233;5219;8452;8326
2920403;BA;Manoel Vitorino;16704;7338;7052;7359;7031;14390;12944
2920452;BA;Mansidão;11046;6587;6007;4784;7810;12594;13822
2920502;BA;Maracás;31683;12203;12412;17709;6906;24615;19973
2920601;BA;Maragogipe;40314;21519;21296;25092;17723;42815;44902
2920700;BA;Maraú;18366;10078;9019;3561;15536;19097;20664
2920809;BA;Marcionílio Souza;10775;5310;5198;5317;5191;10508;10357
2920908;BA;Mascote;16093;7548;7092;11669;2971;14640;13619
2921005;BA;Mata de São João;32568;19891;20319;29852;10358;40210;47643
2921054;BA;Matina;10242;5686;5448;3485;7649;11134;12359
2921104;BA;Medeiros Neto;21235;11043;10498;17057;4484;21541;22741
2921203;BA;Miguel Calmon;28267;13191;13275;16060;10406;26466;25771
2921302;BA;Milagres;12067;5003;5303;7789;2517;10306;10838
2921401;BA;Mirangaba;14261;8200;8123;7494;8829;16323;18603
2921450;BA;Mirante;13666;5394;5118;1809;8703;10512;8264
2921500;BA;Monte Santo;54552;26601;25759;8845;43515;52360;49145
2921609;BA;Morpará;8597;4243;4042;5539;2746;8285;8476
2921708;BA;Morro do Chapéu;34494;17711;17496;20281;14926;35207;35466
2921807;BA;Mortugaba;12598;6219;6263;5889;6593;12482;12063
2921906;BA;Mucugê;13682;5231;5317;4183;6365;10548;8725
2922003;BA;Mucuri;28062;18171;17872;27484;8559;36043;42729
2922052;BA;Mulungu do Morro;15119;6181;6089;5934;6336;12270;10469
2922102;BA;Mundo Novo;21273;12390;12029;13588;10831;24419;27153
2922201;BA;Muniz Ferreira;6941;3678;3632;3394;3916;7310;7464
2922250;BA;Muquém de São Francisco;9052;5449;4823;1283;8989;10272;11479
2922300;BA;Muritiba;30644;13717;15180;18038;10859;28897;29420
2922409;BA;Mutuípe;20462;10617;10849;9669;11797;21466;22340
2922508;BA;Nazaré;26365;13233;14036;22861;4408;27269;28661
2922607;BA;Nilo Peçanha;11213;6463;6067;3104;9426;12530;14156
2922656;BA;Nordestina;11800;6418;5980;3932;8466;12398;13197
2922706;BA;Nova Canaã;15366;8573;8154;6836;9891;16727;16482
2922730;BA;Nova Fátima;7536;3793;3809;5074;2528;7602;7830
2922755;BA;Nova Ibiá;7166;3488;3160;2801;3847;6648;6518
2922805;BA;Nova Itarana;6592;3770;3668;2715;4723;7438;8328
2922854;BA;Nova Redenção;8636;4069;3965;5237;2797;8034;9126
2922904;BA;Nova Soure;24405;12128;12004;11730;12402;24132;27047
2923001;BA;Nova Viçosa;32076;19385;19152;33518;5019;38537;44170
2923035;BA;Novo Horizonte;8502;5502;5171;3505;7168;10673;12653
2923050;BA;Novo Triunfo;13599;7529;7528;7505;7552;15057;15445
2923100;BA;Olindina;23909;12291;12652;12777;12166;24943;28373
2923209;BA;Oliveira dos Brejinhos;21670;11128;10711;6583;15256;21839;21797
2923308;BA;Ouriçangas;7525;4206;4081;2755;5532;8287;8575
2923357;BA;Ourolândia;15356;8387;8090;6361;10116;16477;17567
2923407;BA;Palmas de Monte Alto;20099;10598;10181;9830;10949;20779;21840
2923506;BA;Palmeiras;7518;4174;4234;5237;3171;8408;9123
2923605;BA;Paramirim;18921;10565;10433;10029;10969;20998;21777
2923704;BA;Paratinga;27679;14917;14558;10915;18560;29475;32274
2923803;BA;Paripiranga;26591;13670;14112;9534;18248;27782;29124
2923902;BA;Pau Brasil;13048;5495;5358;7383;3470;10853;9550
2924009;BA;Paulo Afonso;96499;51957;56462;93457;14962;108419;119213
2924058;BA;Pé de Serra;13531;6817;6935;5174;8578;13752;13535
2924108;BA;Pedrão;6764;3411;3485;1711;5185;6896;7438
2924207;BA;Pedro Alexandre;16953;8683;8312;2786;14209;16995;16698
2924306;BA;Piatã;18977;8738;9247;7611;10374;17985;16854
2924405;BA;Pilão Arcado;30713;16674;16141;11006;21809;32815;35295
2924504;BA;Pindaí;15494;8014;7615;4319;11310;15629;16308
2924603;BA;Pindobaçu;20869;10324;9795;11235;8884;20119;20048
2924652;BA;Pintadas;10927;5199;5146;5842;4503;10345;10353
2924678;BA;Piraí do Norte;10425;5177;4658;3696;6139;9835;10050
2924702;BA;Piripá;16128;6445;6344;6196;6593;12789;10253
2924801;BA;Piritiba;19037;11287;11124;15156;7255;22411;25162
2924900;BA;Planaltino;7963;4572;4250;3640;5182;8822;9415
2925006;BA;Planalto;21707;12104;12393;14878;9619;24497;26581
2925105;BA;Poções;44213;21804;22956;34698;10062;44760;46885
2925204;BA;Pojuca;26203;16082;16982;28373;4691;33064;40401
2925253;BA;Ponto Novo;17187;7924;7817;8405;7336;15741;14729
2925303;BA;Porto Seguro;95721;63393;63377;104090;22680;126770;152529
2925402;BA;Potiraguá;14579;5077;4752;6604;3225;9829;6623
2925501;BA;Prado;26498;13975;13637;15454;12158;27612;28214
2925600;BA;Presidente Dutra;13730;7002;6754;9057;4699;13756;15180
2925709;BA;Presidente Jânio Quadros;17045;6985;6672;4198;9459;13657;12028
2925758;BA;Presidente Tancredo Neves;19404;12222;11635;9576;14281;23857;28272
2925808;BA;Queimadas;24613;12277;12306;12492;12091;24583;25428
2925907;BA;Quijingue;26376;14019;13224;6384;20859;27243;27672
2925931;BA;Quixabeira;9466;4877;4671;3663;5885;9548;8939
2925956;BA;Rafael Jambeiro;22600;12515;13040;7238;18317;25555;22643
2926004;BA;Remanso;36257;19545;19604;23607;15542;39149;41324
2926103;BA;Retirolândia;10891;6027;6032;6726;5333;12059;14588
2926202;BA;Riachão das Neves;21917;11443;10498;10746;11195;21941;22330
2926301;BA;Riachão do Jacuípe;31633;16124;16957;19860;13221;33081;33498
2926400;BA;Riacho de Santana;28643;15596;15055;13096;17555;30651;35757
2926509;BA;Ribeira do Amparo;13903;7234;7033;1921;12346;14267;14631
2926608;BA;Ribeira do Pombal;46270;23749;24522;29775;18496;48271;54097
2926657;BA;Ribeirão do Largo;15303;4474;4099;4624;3949;8573;4896
2926707;BA;Rio de Contas;13935;6221;6758;6300;6679;12979;12878
2926806;BA;Rio do Antônio;14637;7424;7362;5976;8810;14786;15521
2926905;BA;Rio do Pires;12010;5935;5988;5267;6656;11923;11672
2927002;BA;Rio Real;33260;18628;18499;23302;13825;37127;41209
2927101;BA;Rodelas;6260;3844;3935;6542;1237;7779;9548
2927200;BA;Ruy Barbosa;29026;14542;15327;22070;7799;29869;30900
2927309;BA;Salinas da Margarida;10377;6558;6907;5972;7493;13465;16047
2927408;BA;Salvador;2443107;1249301;1427305;2675875;731;2676606;2900319
2927507;BA;Santa Bárbara;17933;9301;9763;8669;10395;19064;20971
2927606;BA;Santa Brígida;16903;7709;7350;5617;9442;15059;13917
2927705;BA;Santa Cruz Cabrália;23888;13316;12882;18993;7205;26198;28058
2927804;BA;Santa Cruz da Vitória;7025;3422;3251;5076;1597;6673;6241
2927903;BA;Santa Inês;11027;5135;5228;9514;849;10363;10583
2928000;BA;Santaluz;30955;16616;17200;20801;13015;33816;37704
2928059;BA;Santa Luzia;15503;7051;6281;8072;5260;13332;12308
2928109;BA;Santa Maria da Vitória;41261;20341;19975;23820;16496;40316;39707
2928208;BA;Santana;24139;12549;12198;13483;11264;24747;26792
2928307;BA;Santanópolis;8644;4254;4527;1684;7097;8781;8987
2928406;BA;Santa Rita de Cássia;24026;13577;12684;14912;11349;26261;28613
2928505;BA;Santa Teresinha;8696;4826;4832;2334;7324;9658;10520
2928604;BA;Santo Amaro;58414;27760;30051;44778;13033;57811;60190
2928703;BA;Santo Antônio de Jesus;77368;42986;47963;79271;11678;90949;103204
2928802;BA;Santo Estêvão;41145;22939;24962;27707;20194;47901;53666
2928901;BA;São Desidério;19006;14551;13141;8637;19055;27692;34764
2928950;BA;São Domingos;8526;4593;4628;5918;3303;9221;9085
2929008;BA;São Félix;13699;6881;7218;9266;4833;14099;14784
2929057;BA;São Félix do Coribe;11758;6534;6508;10582;2460;13042;15543
2929107;BA;São Felipe;20228;10083;10222;9820;10485;20305;21083
2929206;BA;São Francisco do Conde;26282;16216;16956;27412;5760;33172;40664
2929255;BA;São Gabriel;18412;9445;8974;10486;7933;18419;18785
2929305;BA;São Gonçalo dos Campos;27000;16032;17257;16503;16786;33289;38315
2929354;BA;São José da Vitória;6210;2902;2813;5162;553;5715;5562
2929370;BA;São José do Jacuípe;9233;5115;5098;6997;3216;10213;10546
2929404;BA;São Miguel das Matas;10020;5278;5136;3360;7054;10414;11733
2929503;BA;São Sebastião do Passé;39960;20708;21445;33112;9041;42153;44554
2929602;BA;Sapeaçu;16450;7990;8607;8087;8510;16597;17421
2929701;BA;Sátiro Dias;17251;9371;9217;4326;14262;18588;17330
2929750;BA;Saubara;10193;5480;5721;10948;253;11201;12163
2929800;BA;Saúde;11488;5934;5913;6646;5201;11847;12971
2929909;BA;Seabra;39422;20690;21125;20292;21523;41815;44370
2930006;BA;Sebastião Laranjeiras;9283;5256;5116;4084;6288;10372;11586
2930105;BA;Senhor do Bonfim;67723;36030;38401;57574;16857;74431;79813
2930154;BA;Serra do Ramalho;32600;16381;15265;6282;25364;31646;31362
2930204;BA;Sento Sé;32461;19278;18153;21676;15755;37431;41279
2930303;BA;Serra Dourada;18015;9243;8869;6002;12110;18112;17261
2930402;BA;Serra Preta;17726;7587;7814;6920;8481;15401;14531
2930501;BA;Serrinha;83206;37936;39349;47177;30108;77285;81693
2930600;BA;Serrolândia;12616;6042;6305;7282;5065;12347;13490
2930709;BA;Simões Filho;94066;57978;60042;105808;12212;118020;137117
2930758;BA;Sítio do Mato;11752;6267;5784;6866;5185;12051;13104
2930766;BA;Sítio do Quinto;17031;6291;6312;5185;7418;12603;9431
2930774;BA;Sobradinho;21325;10793;11195;19999;1989;21988;23274
2930808;BA;Souto Soares;14795;8052;7847;6039;9860;15899;17118
2930907;BA;Tabocas do Brejo Velho;12619;5940;5488;3932;7496;11428;12515
2931004;BA;Tanhaçu;20044;10077;9945;8299;11723;20022;20383
2931053;BA;Tanque Novo;15771;8130;8003;7322;8811;16133;17518
2931103;BA;Tanquinho;7460;3976;4032;5711;2297;8008;7936
2931202;BA;Taperoá;15933;9606;9185;8725;10066;18791;21421
2931301;BA;Tapiramutá;17061;8360;8168;12791;3737;16528;16939
2931350;BA;Teixeira de Freitas;107486;68173;70318;129412;9079;138491;164290
2931400;BA;Teodoro Sampaio;8884;3856;4039;6341;1554;7895;7296
2931509;BA;Teofilândia;20432;10801;10683;6692;14792;21484;22590
2931608;BA;Teolândia;12572;7734;7116;5068;9782;14850;15097
2931707;BA;Terra Nova;12875;6223;6583;11491;1315;12806;13018
2931806;BA;Tremedal;21200;8535;8497;3937;13095;17032;15996
2931905;BA;Tucano;50948;26248;26143;21947;30444;52391;50903
2932002;BA;Uauá;25993;12219;12083;10769;13533;24302;23991
2932101;BA;Ubaíra;20595;10037;9722;8258;11501;19759;19860
2932200;BA;Ubaitaba;23854;10102;10595;17604;3093;20697;18647
2932309;BA;Ubatã;21803;12494;12521;17958;7057;25015;27481
2932408;BA;Uibaí;13614;6983;6672;8335;5320;13655;13894
2932457;BA;Umburanas;14140;8784;8226;7513;9497;17010;19573
2932507;BA;Una;31261;12554;11552;15030;9076;24106;18108
2932606;BA;Urandi;16076;8343;8156;5946;10553;16499;16672
2932705;BA;Uruçuca;20323;9860;9980;15779;4061;19840;20312
2932804;BA;Utinga;16889;8944;9249;12817;5376;18193;19330
2932903;BA;Valença;77509;43564;45165;64401;24328;88729;97873
2933000;BA;Valente;19145;12162;12417;13491;11088;24579;29111
2933059;BA;Várzea da Roça;13633;6982;6805;6476;7311;13787;14135
2933109;BA;Várzea do Poço;7515;4357;4307;5789;2875;8664;9247
2933158;BA;Várzea Nova;14154;6623;6504;8611;4516;13127;12556
2933174;BA;Varzedo;8673;4533;4588;3371;5750;9121;8734
2933208;BA;Vera Cruz;29750;18733;18854;35264;2323;37587;44185
2933257;BA;Vereda;7450;3565;3237;1379;5423;6802;6105
2933307;BA;Vitória da Conquista;262494;147677;158697;274805;31569;306374;343643
2933406;BA;Wagner;8976;4498;4485;6482;2501;8983;9342
2933455;BA;Wanderley;13649;6496;5989;5878;6607;12485;12125
2933505;BA;Wenceslau Guimarães;23926;11458;10723;7512;14669;22181;20862
2933604;BA;Xique-Xique;44718;22536;23026;32552;13010;45562;46562
3100104;MG;Abadia dos Dourados;6446;3399;3305;4189;2515;6704;7022
3100203;MG;Abaeté;22360;11229;11471;19714;2986;22700;23263
3100302;MG;Abre Campo;13348;6670;6641;7284;6027;13311;13434
3100401;MG;Acaiaca;3889;1895;2029;2553;1371;3924;3995
3100500;MG;Açucena;11489;5231;5067;4826;5472;10298;9270
3100609;MG;Água Boa;17795;7739;7454;7042;8151;15193;13319
3100708;MG;Água Comprida;2092;1071;949;1516;504;2020;1986
3100807;MG;Aguanil;3562;2055;1994;2337;1712;4049;4557
3100906;MG;Águas Formosas;17845;9318;9164;14321;4161;18482;19285
3101003;MG;Águas Vermelhas;11878;6527;6191;8943;3775;12718;13656
3101102;MG;Aimorés;25105;12060;12909;19705;5264;24969;25116
3101201;MG;Aiuruoca;6469;3212;2961;3123;3050;6173;5949
3101300;MG;Alagoa;2800;1408;1301;1110;1599;2709;2657
3101409;MG;Albertina;2841;1488;1425;2012;901;2913;3015
3101508;MG;Além Paraíba;33610;16541;17800;32062;2279;34341;35438
3101607;MG;Alfenas;66957;36049;37673;69127;4595;73722;80973
3101631;MG;Alfredo Vasconcelos;5101;3116;2962;4032;2046;6078;7052
3101706;MG;Almenara;35385;19536;19243;31751;7028;38779;42380
3101805;MG;Alpercata;6966;3590;3582;5660;1512;7172;7448
3101904;MG;Alpinópolis;17031;9494;8996;14994;3496;18490;20059
3102001;MG;Alterosa;12976;6978;6736;10000;3714;13714;14566
3102050;MG;Alto Caparaó;4673;2726;2571;3972;1325;5297;5938
3102100;MG;Alto Rio Doce;13858;6102;6056;5069;7089;12158;10723
3102209;MG;Alvarenga;5212;2237;2206;2119;2324;4443;3783
3102308;MG;Alvinópolis;15588;7536;7727;11433;3830;15263;15135
3102407;MG;Alvorada de Minas;3527;1777;1771;1450;2098;3548;3605
3102506;MG;Amparo do Serra;5477;2484;2568;2642;2410;5052;4643
3102605;MG;Andradas;32968;18707;18595;28059;9243;37302;41704
3102704;MG;Cachoeira de Pajeú;8523;4508;4454;4457;4505;8962;9470
3102803;MG;Andrelândia;12310;6061;6085;9798;2348;12146;12189
3102852;MG;Angelândia;7468;3950;4053;4036;3967;8003;8594
3102902;MG;Antônio Carlos;10870;5523;5589;7836;3276;11112;11471
3103009;MG;Antônio Dias;10044;4831;4742;4671;4902;9573;9233
3103108;MG;Antônio Prado de Minas;1794;861;812;1004;669;1673;1577
3103207;MG;Araçaí;2145;1085;1162;1787;460;2247;2360
3103306;MG;Aracitaba;2086;1053;1004;1640;417;2057;2056
3103405;MG;Araçuaí;35713;17854;18187;23430;12611;36041;36715
3103504;MG;Araguari;101974;54135;55644;102558;7221;109779;118361
3103603;MG;Arantina;2906;1415;1408;2633;190;2823;2779
3103702;MG;Araponga;7916;4198;3967;3043;5122;8165;8467
3103751;MG;Araporã;5309;3163;3070;5904;329;6233;6992
3103801;MG;Arapuá;2744;1405;1367;2085;687;2772;2836
3103900;MG;Araújos;6217;4011;3873;6813;1071;7884;9523
3104007;MG;Araxá;78997;46275;47408;92300;1383;93683;108403
3104106;MG;Arceburgo;8035;4914;4595;8179;1330;9509;10990
3104205;MG;Arcos;32687;18208;18374;33962;2620;36582;40658
3104304;MG;Areado;12228;6925;6804;11530;2199;13729;15288
3104403;MG;Argirita;3173;1485;1416;2192;709;2901;2681
3104452;MG;Aricanduva;4255;2426;2344;1697;3073;4770;5305
3104502;MG;Arinos;17709;9172;8502;10851;6823;17674;17850
3104601;MG;Astolfo Dutra;11805;6553;6496;11882;1167;13049;14358
3104700;MG;Ataléia;16747;7307;7144;7199;7252;14451;12496
3104809;MG;Augusto de Lima;5159;2526;2436;2926;2036;4962;4833
3104908;MG;Baependi;17523;9164;9128;13245;5047;18292;19249
3105004;MG;Baldim;8155;3948;3969;5068;2849;7917;7780
3105103;MG;Bambuí;21697;11241;11468;19313;3396;22709;23964
3105202;MG;Bandeira;5318;2538;2450;2378;2610;4988;4738
3105301;MG;Bandeira do Sul;4899;2742;2598;4872;468;5340;5808
3105400;MG;Barão de Cocais;23391;14065;14367;25772;2660;28432;33232
3105509;MG;Barão de Monte Alto;6232;2843;2884;4120;1607;5727;5311
3105608;MG;Barbacena;114126;60155;66170;115617;10708;126325;139061
3105707;MG;Barra Longa;7554;3024;3123;2313;3834;6147;4905
3105905;MG;Barroso;18359;9558;10065;19003;620;19623;20981
3106002;MG;Bela Vista de Minas;9846;4823;5189;9384;628;10012;10269
3106101;MG;Belmiro Braga;3427;1722;1682;1099;2305;3404;3422
3106200;MG;Belo Horizonte;2238526;1113654;1261790;2375444;0;2375444;2530701
3106309;MG;Belo Oriente;19516;11616;11781;19665;3732;23397;27277
3106408;MG;Belo Vale;7429;3776;3760;3295;4241;7536;7723
3106507;MG;Berilo;12979;6286;6021;3892;8415;12307;11813
3106606;MG;Bertópolis;4436;2384;2114;2731;1767;4498;4609
3106655;MG;Berizal;3970;2193;2178;2484;1887;4371;4792
3106705;MG;Betim;306675;186104;191443;374789;2758;377547;450024
3106804;MG;Bias Fortes;4392;1972;1824;1502;2294;3796;3282
3106903;MG;Bicas;12793;6558;7095;12957;696;13653;14612
3107000;MG;Biquinhas;2821;1322;1312;1639;995;2634;2482
3107109;MG;Boa Esperança;37074;19263;19246;32188;6321;38509;40308
3107208;MG;Bocaina de Minas;4983;2634;2366;2394;2606;5000;5088
3107307;MG;Bocaiúva;42806;23329;23266;36597;9998;46595;50521
3107406;MG;Bom Despacho;39943;22627;22999;42965;2661;45626;51436
3107505;MG;Bom Jardim de Minas;6643;3251;3262;5585;928;6513;6444
3107604;MG;Bom Jesus da Penha;3523;2023;1859;2825;1057;3882;4270
3107703;MG;Bom Jesus do Amparo;4817;2713;2782;2516;2979;5495;6182
3107802;MG;Bom Jesus do Galho;16173;7833;7543;10030;5346;15376;14792
3107901;MG;Bom Repouso;10514;5444;5013;5679;4778;10457;10527
3108008;MG;Bom Sucesso;17064;8551;8693;14195;3049;17244;17612
3108107;MG;Bonfim;6866;3419;3397;3330;3486;6816;6852
3108206;MG;Bonfinópolis de Minas;6443;2978;2889;4142;1725;5867;5397
3108255;MG;Bonito de Minas;7863;4995;4676;2211;7460;9671;11502
3108305;MG;Borda da Mata;14439;8673;8456;13729;3400;17129;19809
3108404;MG;Botelhos;15101;7479;7456;11368;3567;14935;14927
3108503;MG;Botumirim;6834;3395;3102;3470;3027;6497;6259
3108552;MG;Brasilândia de Minas;11473;7384;6842;12372;1854;14226;16950
3108602;MG;Brasília de Minas;30266;15597;15624;20672;10549;31221;32460
3108701;MG;Brás Pires;5107;2331;2319;2231;2419;4650;4255
3108800;MG;Braúnas;5408;2466;2568;1596;3438;5034;4737
3108909;MG;Brasópolis;15165;7431;7232;7891;6772;14663;14364
3109006;MG;Brumadinho;26614;17027;16986;28687;5326;34013;41208
3109105;MG;Bueno Brandão;10932;5659;5233;5675;5217;10892;10982
3109204;MG;Buenópolis;10368;5168;5123;7767;2524;10291;10342
3109253;MG;Bugre;3949;2029;1961;1528;2462;3990;3984
3109303;MG;Buritis;20396;11544;11185;16103;6626;22729;25179
3109402;MG;Buritizeiro;25904;13525;13396;23618;3303;26921;28184
3109451;MG;Cabeceira Grande;5920;3394;3059;5297;1156;6453;7025
3109501;MG;Cabo Verde;13727;7452;6371;7627;6196;13823;14074
3109600;MG;Cachoeira da Prata;3780;1718;1936;3528;126;3654;3580
3109709;MG;Cachoeira de Minas;10555;5767;5267;7064;3970;11034;11609
3109808;MG;Cachoeira Dourada;2305;1250;1256;2226;280;2506;2720
3109907;MG;Caetanópolis;8571;5121;5106;8391;1836;10227;11869
3110004;MG;Caeté;36299;19857;20929;35451;5335;40786;45364
3110103;MG;Caiana;4367;2588;2382;2618;2352;4970;5584
3110202;MG;Cajuri;4190;2121;1926;2096;1951;4047;3961
3110301;MG;Caldas;12766;6953;6677;7741;5889;13630;14600
3110400;MG;Camacho;3533;1665;1489;1458;1696;3154;2839
3110509;MG;Camanducaia;20537;10867;10207;15475;5599;21074;21831
3110608;MG;Cambuí;22969;13234;13257;22362;4129;26491;30068
3110707;MG;Cambuquira;12538;6251;6407;10513;2145;12658;12810
3110806;MG;Campanário;3419;1732;1827;2646;913;3559;3739
3110905;MG;Campanha;14098;7761;7674;13328;2107;15435;16855
3111002;MG;Campestre;20553;10767;9934;10971;9730;20701;21052
3111101;MG;Campina Verde;19100;9790;9495;14413;4872;19285;19759
3111150;MG;Campo Azul;3574;1947;1738;1554;2131;3685;3830
3111200;MG;Campo Belo;49187;25121;26388;48600;2909;51509;54338
3111309;MG;Campo do Meio;11436;5856;5662;10106;1412;11518;11648
3111408;MG;Campo Florido;5328;3679;3191;5208;1662;6870;8383
3111507;MG;Campos Altos;12819;7266;6947;12921;1292;14213;15661
3111606;MG;Campos Gerais;26541;14062;13561;19177;8446;27623;28908
3111705;MG;Canaã;4789;2375;2256;1859;2772;4631;4533
3111804;MG;Canápolis;10633;5981;5376;10172;1185;11357;12251
3111903;MG;Cana Verde;5664;2861;2728;4068;1521;5589;5585
3112000;MG;Candeias;14461;7463;7129;10204;4388;14592;14890
3112059;MG;Cantagalo;3838;2045;2145;2478;1712;4190;4575
3112109;MG;Caparaó;5000;2743;2466;2006;3203;5209;5464
3112208;MG;Capela Nova;4964;2335;2423;2135;2623;4758;4616
3112307;MG;Capelinha;31231;17144;17652;24749;10047;34796;38321
3112406;MG;Capetinga;7424;3741;3348;5919;1170;7089;6860
3112505;MG;Capim Branco;7900;4415;4465;8089;791;8880;9896
3112604;MG;Capinópolis;14403;7829;7468;14309;988;15297;16294
3112653;MG;Capitão Andrade;4306;2422;2507;3578;1351;4929;5559
3112703;MG;Capitão Enéas;13113;7202;7004;11520;2686;14206;15388
3112802;MG;Capitólio;7737;4166;4019;6504;1681;8185;8693
3112901;MG;Caputira;8834;4641;4392;3782;5251;9033;9318
3113008;MG;Caraí;20981;11294;11049;7190;15153;22343;23872
3113107;MG;Caranaíba;3478;1678;1610;1177;2111;3288;3150
3113206;MG;Carandaí;21057;11554;11787;18199;5142;23341;25831
3113305;MG;Carangola;31921;15702;16619;26079;6242;32321;33022
3113404;MG;Caratinga;77789;41729;43593;70548;14774;85322;93124
3113503;MG;Carbonita;8967;4681;4477;6744;2414;9158;9423
3113602;MG;Careaçu;5810;3226;3076;4706;1596;6302;6826
3113701;MG;Carlos Chagas;21994;10006;10081;13034;7053;20087;18516
3113800;MG;Carmésia;2246;1227;1233;1321;1139;2460;2660
3113909;MG;Carmo da Cachoeira;11600;5976;5860;8966;2870;11836;12193
3114006;MG;Carmo da Mata;10400;5452;5475;8610;2317;10927;11546
3114105;MG;Carmo de Minas;12545;6896;6856;10189;3563;13752;15031
3114204;MG;Carmo do Cajuru;17157;10034;9984;17341;2677;20018;22900
3114303;MG;Carmo do Paranaíba;29460;15042;14710;25216;4536;29752;30339
3114402;MG;Carmo do Rio Claro;19732;10483;9943;14362;6064;20426;21310
3114501;MG;Carmópolis de Minas;14348;8762;8288;11823;5227;17050;19756
3114550;MG;Carneirinho;8910;4866;4601;6971;2496;9467;10103
3114600;MG;Carrancas;3887;2009;1943;2613;1339;3952;4052
3114709;MG;Carvalhópolis;3089;1705;1645;2461;889;3350;3614
3114808;MG;Carvalhos;4733;2343;2212;2436;2119;4555;4445
3114907;MG;Casa Grande;2264;1153;1089;1122;1120;2242;2251
3115003;MG;Cascalho Rico;2622;1527;1330;1796;1061;2857;3108
3115102;MG;Cássia;17278;8807;8621;14237;3191;17428;17741
3115201;MG;Conceição da Barra de Minas;4021;2067;1894;2795;1166;3961;3939
3115300;MG;Cataguases;63980;34240;35570;66833;2977;69810;75942
3115359;MG;Catas Altas;4241;2384;2455;4233;606;4839;5465
3115409;MG;Catas Altas da Noruega;3288;1761;1701;1429;2033;3462;3665
3115458;MG;Catuji;7332;3355;3350;1688;5017;6705;6206
3115474;MG;Catuti;5337;2629;2473;2978;2124;5102;4944
3115508;MG;Caxambu;22129;10532;11187;21266;453;21719;21566
3115607;MG;Cedro do Abaeté;1289;628;584;1033;179;1212;1150
3115706;MG;Central de Minas;6548;3302;3472;5596;1178;6774;7059
3115805;MG;Centralina;10236;5252;5018;9316;954;10270;10343
3115904;MG;Chácara;2370;1410;1382;1903;889;2792;3216
3116001;MG;Chalé;5663;2868;2779;2783;2864;5647;5695
3116100;MG;Chapada do Norte;15225;7422;7743;5702;9463;15165;15334
3116159;MG;Chapada Gaúcha;7270;5624;5168;5751;5041;10792;14217
3116209;MG;Chiador;2958;1355;1430;1486;1299;2785;2657
3116308;MG;Cipotânea;6345;3347;3200;3014;3533;6547;6811
3116407;MG;Claraval;4242;2371;2173;2532;2012;4544;4873
3116506;MG;Claro dos Poções;8193;3964;3817;5257;2524;7781;7478
3116605;MG;Cláudio;22522;13090;12687;21160;4617;25777;29093
3116704;MG;Coimbra;6523;3548;3506;5156;1898;7054;7631
3116803;MG;Coluna;9369;4480;4544;3814;5210;9024;8810
3116902;MG;Comendador Gomes;2842;1591;1381;1508;1464;2972;3128
3117009;MG;Comercinho;10204;4231;4078;3555;4754;8309;6624
3117108;MG;Conceição da Aparecida;9372;5008;4806;6201;3613;9814;10351
3117207;MG;Conceição das Pedras;2714;1468;1281;1509;1240;2749;2814
3117306;MG;Conceição das Alagoas;17156;12054;11001;20892;2163;23055;28782
3117405;MG;Conceição de Ipanema;4377;2248;2219;1534;2933;4467;4581
3117504;MG;Conceição do Mato Dentro;18637;9004;8910;12274;5640;17914;17438
3117603;MG;Conceição do Pará;4793;2657;2505;2015;3147;5162;5558
3117702;MG;Conceição do Rio Verde;12273;6519;6431;11450;1500;12950;13729
3117801;MG;Conceição dos Ouros;8929;5311;5077;8123;2265;10388;11852
3117836;MG;Cônego Marinho;6477;3596;3493;1915;5174;7089;7730
3117876;MG;Confins;4880;2929;3014;5943;0;5943;6867
3117900;MG;Congonhal;8726;5412;5068;7766;2714;10480;12209
3118007;MG;Congonhas;41256;23864;24686;47253;1297;48550;55836
3118106;MG;Congonhas do Norte;4897;2481;2466;2602;2345;4947;5047
3118205;MG;Conquista;6101;3313;3214;5672;855;6527;6997
3118304;MG;Conselheiro Lafaiete;102836;56395;60132;111286;5241;116527;130584
3118403;MG;Conselheiro Pena;21734;10745;11487;17591;4641;22232;22975
3118502;MG;Consolação;1699;888;839;950;777;1727;1786
3118601;MG;Contagem;538017;292628;310420;601009;2039;603048;673849
3118700;MG;Coqueiral;9612;4632;4655;6586;2701;9287;9099
3118809;MG;Coração de Jesus;25729;13182;12853;14767;11268;26035;26620
3118908;MG;Cordisburgo;8522;4435;4232;5961;2706;8667;8903
3119005;MG;Cordislândia;3359;1769;1666;2757;678;3435;3546
3119104;MG;Corinto;24546;11756;12145;21191;2710;23901;23607
3119203;MG;Coroaci;10802;5229;5045;5182;5092;10274;9897
3119302;MG;Coromandel;27452;13959;13592;21669;5882;27551;27958
3119401;MG;Coronel Fabriciano;97451;50066;53731;102498;1299;103797;110709
3119500;MG;Coronel Murta;9134;4657;4460;6693;2424;9117;9209
3119609;MG;Coronel Pacheco;2900;1515;1468;2145;838;2983;3095
3119708;MG;Coronel Xavier Chaves;3185;1645;1656;1799;1502;3301;3448
3119807;MG;Córrego Danta;3674;1789;1602;2088;1303;3391;3168
3119906;MG;Córrego do Bom Jesus;3827;1950;1782;2051;1681;3732;3685
3119955;MG;Córrego Fundo;5179;3001;2820;4438;1383;5821;6425
3120003;MG;Córrego Novo;3638;1559;1570;2039;1090;3129;2688
3120102;MG;Couto de Magalhães de Minas;4007;2103;2101;3835;369;4204;4436
3120151;MG;Crisólita;5298;3076;2964;3489;2551;6040;6814
3120201;MG;Cristais;9518;5771;5530;8854;2447;11301;13060
3120300;MG;Cristália;5583;2911;2849;3053;2707;5760;5992
3120409;MG;Cristiano Otoni;4905;2516;2491;4156;851;5007;5161
3120508;MG;Cristina;10339;5226;4988;5961;4253;10214;10211
3120607;MG;Crucilândia;4477;2421;2328;2976;1773;4749;5072
3120706;MG;Cruzeiro da Fortaleza;3720;2008;1926;3361;573;3934;3651
3120805;MG;Cruzília;13765;7254;7342;13295;1301;14596;15529
3120839;MG;Cuparaque;4367;2355;2325;3885;795;4680;5026
3120870;MG;Curral de Dentro;5973;3502;3428;5852;1078;6930;7867
3120904;MG;Curvelo;67512;36115;38069;67363;6821;74184;81085
3121001;MG;Datas;5040;2548;2662;3092;2118;5210;5431
3121100;MG;Delfim Moreira;8032;4187;3784;3025;4946;7971;8007
3121209;MG;Delfinópolis;6577;3550;3280;4846;1984;6830;7146
3121258;MG;Delta;5065;4563;3544;7597;510;8107;10994
3121308;MG;Descoberto;4531;2401;2356;4069;688;4757;5044
3121407;MG;Desterro de Entre Rios;6807;3572;3430;3596;3406;7002;7266
3121506;MG;Desterro do Melo;3211;1544;1465;1390;1619;3009;2867
3121605;MG;Diamantina;44259;22251;23633;40062;5822;45884;47924
3121704;MG;Diogo de Vasconcelos;3972;1930;1918;1099;2749;3848;3779
3121803;MG;Dionísio;10191;4304;4435;7165;1574;8739;7493
3121902;MG;Divinésia;3188;1661;1631;2174;1118;3292;3430
3122009;MG;Divino;18420;9684;9447;10795;8336;19131;20020
3122108;MG;Divino das Laranjeiras;4965;2460;2477;4108;829;4937;4969
3122207;MG;Divinolândia de Minas;6434;3483;3553;5772;1264;7036;7655
3122306;MG;Divinópolis;183962;103876;109200;207573;5503;213076;242505
3122355;MG;Divisa Alegre;4815;2905;2979;5693;191;5884;6946
3122405;MG;Divisa Nova;5539;2982;2778;4660;1100;5760;6039
3122454;MG;Divisópolis;6480;4658;4312;6404;2566;8970;11396
3122470;MG;Dom Bosco;4055;2024;1793;2052;1765;3817;3635
3122504;MG;Dom Cavati;5473;2535;2675;4608;602;5210;5025
3122603;MG;Dom Joaquim;4698;2222;2313;2922;1613;4535;4436
3122702;MG;Dom Silvério;5228;2491;2702;4055;1138;5193;5227
3122801;MG;Dom Viçoso;3034;1544;1450;998;1996;2994;2992
3122900;MG;Dona Eusébia;5362;3038;2963;5133;868;6001;6664
3123007;MG;Dores de Campos;8349;4616;4687;8461;842;9303;10291
3123106;MG;Dores de Guanhães;5380;2612;2611;1622;3601;5223;5139
3123205;MG;Dores do Indaiá;14388;6716;7065;12617;1164;13781;13373
3123304;MG;Dores do Turvo;4799;2299;2140;2023;2416;4439;4202
3123403;MG;Doresópolis;1350;747;693;1132;308;1440;1539
3123502;MG;Douradoquara;1785;970;871;1233;608;1841;1915
3123528;MG;Durandé;7005;3761;3641;3530;3872;7402;7898
3123601;MG;Elói Mendes;21947;12515;12751;20417;4849;25266;28556
3123700;MG;Engenheiro Caldas;9347;4956;5320;8321;1955;10276;11268
3123809;MG;Engenheiro Navarro;7085;3620;3505;4753;2372;7125;7240
3123858;MG;Entre Folhas;5054;2567;2605;3886;1286;5172;5383
3123908;MG;Entre Rios de Minas;13114;7084;7178;9871;4391;14262;15458
3124005;MG;Ervália;17018;9001;8957;9482;8476;17958;19019
3124104;MG;Esmeraldas;47090;30259;29894;56112;4041;60153;72512
3124203;MG;Espera Feliz;20528;11506;11353;14177;8682;22859;25287
3124302;MG;Espinosa;30978;15291;15822;18023;13090;31113;31603
3124401;MG;Espírito Santo do Dourado;4162;2341;2088;1683;2746;4429;4728
3124500;MG;Estiva;10366;5609;5235;4899;5945;10844;11416
3124609;MG;Estrela Dalva;2674;1232;1238;1781;689;2470;2308
3124708;MG;Estrela do Indaiá;3597;1770;1745;2776;739;3515;3483
3124807;MG;Estrela do Sul;6883;3911;3546;6058;1399;7457;8057
3124906;MG;Eugenópolis;9766;5314;5227;7397;3144;10541;11383
3125002;MG;Ewbank da Câmara;3608;1854;1898;3458;294;3752;3932
3125101;MG;Extrema;19219;14407;14157;25992;2572;28564;37649
3125200;MG;Fama;2353;1179;1169;1518;830;2348;2374
3125309;MG;Faria Lemos;3606;1717;1660;2332;1045;3377;3202
3125408;MG;Felício dos Santos;5729;2564;2573;2229;2908;5137;4656
3125507;MG;São Gonçalo do Rio Preto;2963;1474;1565;1952;1087;3039;3178
3125606;MG;Felisburgo;6241;3513;3374;5092;1795;6887;7548
3125705;MG;Felixlândia;12784;7046;7075;10922;3199;14121;15528
3125804;MG;Fernandes Tourinho;2563;1550;1483;2016;1017;3033;3500
3125903;MG;Ferros;12331;5389;5448;5092;5745;10837;9576
3125952;MG;Fervedouro;9671;5330;5021;4764;5587;10351;11100
3126000;MG;Florestal;5647;3245;3358;5501;1102;6603;7602
3126109;MG;Formiga;62907;32089;32975;59452;5612;65064;67956
3126208;MG;Formoso;6522;4280;3893;5173;3000;8173;9810
3126307;MG;Fortaleza de Minas;3759;2101;1997;2950;1148;4098;4460
3126406;MG;Fortuna de Minas;2437;1393;1308;1861;840;2701;2986
3126505;MG;Francisco Badaró;10309;5275;4969;3194;7050;10244;10311
3126604;MG;Francisco Dumont;4488;2541;2326;3201;1666;4867;5268
3126703;MG;Francisco Sá;23562;12945;11973;14902;10016;24918;26459
3126752;MG;Franciscópolis;6426;2969;2834;2398;3405;5803;5287
3126802;MG;Frei Gaspar;5975;2968;2912;1915;3965;5880;5858
3126901;MG;Frei Inocêncio;8176;4360;4564;6768;2156;8924;9716
3126950;MG;Frei Lagonegro;3191;1688;1641;618;2711;3329;3496
3127008;MG;Fronteira;9024;7233;6814;13101;946;14047;18866
3127057;MG;Fronteira dos Vales;4902;2389;2298;3038;1649;4687;4542
3127073;MG;Fruta de Leite;6777;3024;2916;2036;3904;5940;5232
3127107;MG;Frutal;46566;27074;26400;46095;7379;53474;60508
3127206;MG;Funilândia;3281;1958;1896;2029;1825;3854;4434
3127305;MG;Galiléia;7241;3415;3551;5698;1268;6966;6764
3127339;MG;Gameleiras;5263;2624;2515;1413;3726;5139;5084
3127354;MG;Glaucilândia;2767;1498;1466;1048;1916;2964;3177
3127370;MG;Goiabeira;2715;1487;1567;2474;580;3054;3402
3127388;MG;Goianá;3323;1845;1814;2969;690;3659;4014
3127404;MG;Gonçalves;4123;2192;2028;1164;3056;4220;4360
3127503;MG;Gonzaga;5713;2927;2992;3239;2680;5919;6184
3127602;MG;Gouveia;11689;5660;6027;8234;3453;11687;11811
3127701;MG;Governador Valadares;247131;125059;138535;253234;10360;263594;282164
3127800;MG;Grão Mogol;14224;7727;7299;5392;9634;15026;15943
3127909;MG;Grupiara;1376;714;659;1173;200;1373;1386
3128006;MG;Guanhães;27828;15203;16063;25450;5816;31266;34818
3128105;MG;Guapé;13620;7278;6560;7176;6662;13838;14269
3128204;MG;Guaraciaba;10262;5174;5049;3218;7005;10223;10307
3128253;MG;Guaraciama;4469;2378;2341;3027;1692;4719;5005
3128303;MG;Guaranésia;18628;9498;9216;16836;1878;18714;19014
3128402;MG;Guarani;8520;4428;4260;6886;1802;8688;8926
3128501;MG;Guarará;4166;1952;1980;3490;442;3932;3755
3128600;MG;Guarda-Mor;6656;3424;3145;3692;2877;6569;6558
3128709;MG;Guaxupé;47036;24653;24838;46532;2959;49491;52234
3128808;MG;Guidoval;7490;3640;3570;5203;2007;7210;7026
3128907;MG;Guimarânia;6384;3712;3578;5960;1330;7290;8168
3129004;MG;Guiricema;9259;4421;4276;4225;4472;8697;8296
3129103;MG;Gurinhatã;6883;3237;2900;2692;3445;6137;5516
3129202;MG;Heliodora;5657;3116;3004;4430;1690;6120;6623
3129301;MG;Iapu;9718;5139;5192;7175;3156;10331;11085
3129400;MG;Ibertioga;5140;2535;2494;3459;1570;5029;4999
3129509;MG;Ibiá;21044;11872;11393;19695;3570;23265;25511
3129608;MG;Ibiaí;7251;4032;3807;6004;1835;7839;8478
3129657;MG;Ibiracatu;6534;3218;2937;3123;3032;6155;5340
3129707;MG;Ibiraci;10229;6365;5812;8208;3969;12177;14128
3129806;MG;Ibirité;133044;77875;81151;158662;364;159026;184030
3129905;MG;Ibitiúra de Minas;3301;1770;1636;2390;1016;3406;3497
3130002;MG;Ibituruna;2755;1448;1418;2485;381;2866;3003
3130051;MG;Icaraí de Minas;9315;5556;5181;2985;7752;10737;12200
3130101;MG;Igarapé;24838;17544;17335;32675;2204;34879;44561
3130200;MG;Igaratinga;7355;4771;4494;7677;1588;9265;11146
3130309;MG;Iguatama;8269;4034;3997;6716;1315;8031;7901
3130408;MG;Ijaci;5064;2965;2898;5609;254;5863;6667
3130507;MG;Ilicínea;10532;5856;5632;9094;2394;11488;12511
3130556;MG;Imbé de Minas;5911;3287;3125;2043;4369;6412;6976
3130606;MG;Inconfidentes;6479;3517;3387;3681;3223;6904;7387
3130655;MG;Indaiabira;7425;3734;3593;2741;4586;7327;7328
3130705;MG;Indianópolis;5387;3229;2952;4053;2128;6181;7009
3130804;MG;Ingaí;2494;1398;1238;1630;1006;2636;2785
3130903;MG;Inhapim;24895;12122;12147;13975;10294;24269;24020
3131000;MG;Inhaúma;5195;2920;2861;4205;1576;5781;6352
3131109;MG;Inimutaba;6116;3331;3398;4748;1981;6729;7605
3131158;MG;Ipaba;14531;8401;8291;15013;1679;16692;18926
3131208;MG;Ipanema;16286;8806;9363;14204;3965;18169;20133
3131307;MG;Ipatinga;212496;116006;123171;236678;2499;239177;267333
3131406;MG;Ipiaçu;4026;2097;2009;3740;366;4106;4229
3131505;MG;Ipuiúna;8958;4938;4584;7449;2073;9522;10156
3131604;MG;Iraí de Minas;5903;3383;3081;5154;1310;6464;7067
3131703;MG;Itabira;98322;52634;56917;102097;7454;109551;121717
3131802;MG;Itabirinha;9809;5321;5371;8370;2322;10692;11637
3131901;MG;Itabirito;37901;22349;23135;43603;1881;45484;52996
3132008;MG;Itacambira;4558;2675;2307;1006;3976;4982;5447
3132107;MG;Itacarambi;17455;8853;8886;13815;3924;17739;18175
3132206;MG;Itaguara;11302;6268;6103;9530;2841;12371;13510
3132305;MG;Itaipé;10751;6014;5784;4943;6855;11798;12910
3132404;MG;Itajubá;84135;44495;46184;82785;7894;90679;97782
3132503;MG;Itamarandiba;29400;16143;16034;21991;10186;32177;35130
3132602;MG;Itamarati de Minas;3791;2104;1975;3210;869;4079;4395
3132701;MG;Itambacuri;22668;11026;11771;15115;7682;22797;23207
3132800;MG;Itambé do Mato Dentro;2582;1179;1104;908;1375;2283;2032
3132909;MG;Itamogi;10723;5306;5043;7759;2590;10349;10122
3133006;MG;Itamonte;12197;7088;6919;9616;4391;14007;15844
3133105;MG;Itanhandu;12915;6948;7235;11930;2253;14183;15511
3133204;MG;Itanhomi;11572;5796;6054;8564;3286;11850;12259
3133303;MG;Itaobim;21271;10491;10510;15779;5222;21001;20997
3133402;MG;Itapagipe;11832;7145;6524;9560;4109;13669;15511
3133501;MG;Itapecerica;21235;10603;10774;16495;4882;21377;21760
3133600;MG;Itapeva;7361;4505;4168;4518;4155;8673;9976
3133709;MG;Itatiaiuçu;8517;5054;4884;6231;3707;9938;11354
3133758;MG;Itaú de Minas;13691;7403;7547;14567;383;14950;16286
3133808;MG;Itaúna;76862;42071;43325;80391;5005;85396;94455
3133907;MG;Itaverava;6388;2975;2823;2565;3233;5798;5321
3134004;MG;Itinga;13894;7352;7055;6554;7853;14407;15053
3134103;MG;Itueta;5641;2967;2869;3305;2531;5836;6074
3134202;MG;Ituiutaba;89091;47846;49313;93122;4037;97159;105818
3134301;MG;Itumirim;6391;3059;3080;4704;1435;6139;5978
3134400;MG;Iturama;28814;17289;17151;32593;1847;34440;40101
3134509;MG;Itutinga;4140;1995;1918;2756;1157;3913;3749
3134608;MG;Jaboticatubas;13530;8703;8416;10741;6378;17119;20683
3134707;MG;Jacinto;12087;6285;5849;9197;2937;12134;12320
3134806;MG;Jacuí;7389;3873;3629;4570;2932;7502;7695
3134905;MG;Jacutinga;19004;11347;11450;19101;3696;22797;26538
3135001;MG;Jaguaraçu;2855;1505;1477;2139;843;2982;3151
3135050;MG;Jaíba;27287;17344;16243;17635;15952;33587;39850
3135076;MG;Jampruca;4716;2592;2476;3289;1779;5068;5453
3135100;MG;Janaúba;61651;32795;34008;60570;6233;66803;72374
3135209;MG;Januária;63605;32342;33122;41328;24136;65464;67958
3135308;MG;Japaraíba;3473;2014;1936;2553;1397;3950;4418
3135357;MG;Japonvar;8121;4206;4099;3049;5256;8305;7991
3135407;MG;Jeceaba;6109;2723;2673;2979;2417;5396;4795
3135456;MG;Jenipapo de Minas;6490;3664;3453;2882;4235;7117;7781
3135506;MG;Jequeri;13658;6474;6371;7293;5552;12845;12246
3135605;MG;Jequitaí;8750;4033;3977;5499;2511;8010;7407
3135704;MG;Jequitibá;5171;2661;2492;1965;3188;5153;5203
3135803;MG;Jequitinhonha;22902;12297;11882;17065;7114;24179;25555
3135902;MG;Jesuânia;4823;2469;2299;3094;1674;4768;4774
3136009;MG;Joaíma;14555;7489;7441;10275;4655;14930;15476
3136108;MG;Joanésia;6617;2695;2732;2062;3365;5427;4382
3136207;MG;João Monlevade;66690;34963;38488;73120;331;73451;80903
3136306;MG;João Pinheiro;41368;23050;22210;36752;8508;45260;47990
3136405;MG;Joaquim Felício;3872;2216;2089;2526;1779;4305;4757
3136504;MG;Jordânia;9865;5327;4992;7220;3099;10319;10872
3136520;MG;José Gonçalves de Minas;4696;2367;2210;1141;3436;4577;4474
3136553;MG;José Raydan;3647;2220;2156;1568;2808;4376;5104
3136579;MG;Josenópolis;4253;2346;2220;2444;2122;4566;4911
3136603;MG;Nova União;5427;2804;2750;2875;2679;5554;5739
3136652;MG;Juatuba;16389;11235;10986;21846;375;22221;27823
3136702;MG;Juiz de Fora;456796;244932;272940;511993;5879;517872;577532
3136801;MG;Juramento;3901;2053;2057;2268;1842;4110;4359
3136900;MG;Juruaia;7680;4703;4535;4514;4724;9238;10795
3136959;MG;Juvenília;7148;2923;2785;4394;1314;5708;5706
3137007;MG;Ladainha;15832;8394;8605;4310;12689;16999;18272
3137106;MG;Lagamar;7710;3914;3684;5129;2469;7598;7588
3137205;MG;Lagoa da Prata;38758;22857;23142;44952;1047;45999;53236
3137304;MG;Lagoa dos Patos;4454;2201;2026;3079;1148;4227;4062
3137403;MG;Lagoa Dourada;11486;6350;5917;6891;5376;12267;13115
3137502;MG;Lagoa Formosa;16293;8635;8501;12941;4195;17136;18168
3137536;MG;Lagoa Grande;7610;4549;4082;6408;2223;8631;9681
3137601;MG;Lagoa Santa;37872;25778;26748;48953;3573;52526;66744
3137700;MG;Lajinha;19528;9830;9786;12255;7361;19616;19914
3137809;MG;Lambari;18249;9644;9925;14052;5517;19569;20995
3137908;MG;Lamim;3587;1746;1710;1511;1945;3456;3366
3138005;MG;Laranjal;6126;3254;3211;4738;1727;6465;6856
3138104;MG;Lassance;6554;3330;3160;3886;2604;6490;6494
3138203;MG;Lavras;78772;44715;47456;87835;4336;92171;105756
3138302;MG;Leandro Ferreira;3227;1640;1565;2152;1053;3205;3222
3138351;MG;Leme do Prado;4736;2398;2416;1764;3050;4814;4923
3138401;MG;Leopoldina;50097;24545;26591;45712;5424;51136;52690
3138500;MG;Liberdade;5792;2706;2641;3870;1477;5347;4994
3138609;MG;Lima Duarte;15708;8150;8016;12372;3794;16166;16749
3138625;MG;Limeira do Oeste;6170;3532;3358;5017;1873;6890;7640
3138658;MG;Lontra;7640;4372;4029;5645;2756;8401;9766
3138674;MG;Luisburgo;6297;3223;3013;1838;4398;6236;6249
3138682;MG;Luislândia;6121;3298;3107;2985;3420;6405;6735
3138708;MG;Luminárias;5482;2812;2613;4169;1256;5425;5431
3138807;MG;Luz;16833;8718;8774;15715;1777;17492;18297
3138906;MG;Machacalis;6917;3607;3367;5747;1227;6974;7112
3139003;MG;Machado;34877;19341;19343;32068;6616;38684;42682
3139102;MG;Madre de Deus de Minas;4734;2463;2435;3726;1172;4898;5119
3139201;MG;Malacacheta;19250;9169;9618;11828;6959;18787;18556
3139250;MG;Mamonas;6138;3183;3138;2812;3509;6321;6565
3139300;MG;Manga;21959;9802;10044;13875;5971;19846;18051
3139409;MG;Manhuaçu;67123;39214;40421;64866;14769;79635;92074
3139508;MG;Manhumirim;20025;10509;10857;17029;4337;21366;22894
3139607;MG;Mantena;26872;13092;14023;21258;5857;27115;27651
3139706;MG;Maravilhas;6232;3627;3529;4891;2265;7156;8113
3139805;MG;Mar de Espanha;10567;5716;6042;10757;1001;11758;12985
3139904;MG;Maria da Fé;14607;7201;7015;8383;5833;14216;14019
3140001;MG;Mariana;46710;26571;27608;47601;6578;54179;61830
3140100;MG;Marilac;4424;2059;2160;3423;796;4219;4079
3140159;MG;Mário Campos;10535;6643;6571;12481;733;13214;15814
3140209;MG;Maripá de Minas;2594;1389;1399;2266;522;2788;3000
3140308;MG;Marliéria;4044;2002;2019;2843;1178;4021;4030
3140407;MG;Marmelópolis;3293;1491;1477;1557;1411;2968;2701
3140506;MG;Martinho Campos;11817;6371;6218;10986;1603;12589;13497
3140530;MG;Martins Soares;5685;3655;3518;2924;4249;7173;8640
3140555;MG;Mata Verde;7085;4143;3737;6392;1488;7880;8700
3140605;MG;Materlândia;4846;2285;2310;2011;2584;4595;4415
3140704;MG;Mateus Leme;24144;13798;14058;24676;3180;27856;31631
3140803;MG;Matias Barbosa;12323;6692;6743;12944;491;13435;14626
3140852;MG;Matias Cardoso;8600;5093;4884;5137;4840;9977;11360
3140902;MG;Matipó;16291;8727;8912;13832;3807;17639;19098
3141009;MG;Mato Verde;13185;6260;6425;9460;3225;12685;12367
3141108;MG;Matozinhos;30164;16279;16694;29899;3074;32973;38469
3141207;MG;Matutina;3838;1852;1911;2695;1068;3763;3733
3141306;MG;Medeiros;3038;1811;1633;1948;1496;3444;3861
3141405;MG;Medina;21641;10477;10560;15105;5932;21037;20701
3141504;MG;Mendes Pimentel;6286;3152;3177;3453;2876;6329;6446
3141603;MG;Mercês;10061;5157;5215;7261;3111;10372;10775
3141702;MG;Mesquita;6771;3030;3042;3822;2250;6072;5489
3141801;MG;Minas Novas;30646;15360;15443;12590;18213;30803;31509
3141900;MG;Minduri;3834;1889;1951;3396;444;3840;3891
3142007;MG;Mirabela;12552;6629;6414;10029;3014;13043;13651
3142106;MG;Miradouro;9770;5234;5017;5671;4580;10251;10818
3142205;MG;Miraí;12479;6940;6860;10395;3405;13800;15205
3142254;MG;Miravânia;4187;2291;2270;1079;3482;4561;4939
3142304;MG;Moeda;4469;2348;2352;1793;2907;4700;4948
3142403;MG;Moema;6513;3552;3476;6040;988;7028;7589
3142502;MG;Monjolos;2579;1207;1153;1403;957;2360;2184
3142601;MG;Monsenhor Paulo;7615;4186;3982;6140;2028;8168;8764
3142700;MG;Montalvânia;16031;7998;7861;10243;5616;15859;14621
3142809;MG;Monte Alegre de Minas;18006;10048;9568;14512;5104;19616;21349
3142908;MG;Monte Azul;23832;10843;11157;12421;9579;22000;20544
3143005;MG;Monte Belo;13142;6810;6251;9058;4003;13061;13139
3143104;MG;Monte Carmelo;43899;23084;22715;40139;5660;45799;48049
3143153;MG;Monte Formoso;4411;2439;2225;1700;2964;4664;4939
3143203;MG;Monte Santo de Minas;21212;10694;10552;16435;4811;21246;21504
3143302;MG;Montes Claros;306947;174281;187690;344479;17492;361971;417478
3143401;MG;Monte Sião;18195;10655;10548;16269;4934;21203;24247
3143450;MG;Montezuma;6573;3779;3693;3079;4393;7472;8379
3143500;MG;Morada Nova de Minas;7606;4205;4051;6457;1799;8256;8955
3143609;MG;Morro da Garça;2960;1377;1284;1523;1138;2661;2413
3143708;MG;Morro do Pilar;3735;1709;1690;2581;818;3399;3126
3143807;MG;Munhoz;6656;3247;3010;3319;2938;6257;5960
3143906;MG;Muriaé;92101;48847;52014;93320;7541;100861;109997
3144003;MG;Mutum;26693;13477;13195;13798;12874;26672;26945
3144102;MG;Muzambinho;20589;10267;10165;15731;4701;20432;20522
3144201;MG;Nacip Raydan;3122;1586;1568;1979;1175;3154;3221
3144300;MG;Nanuque;41619;19975;20841;36765;4051;40816;40583
3144359;MG;Naque;5601;3194;3147;5961;380;6341;7104
3144375;MG;Natalândia;3293;1738;1550;2475;813;3288;3306
3144409;MG;Natércia;4644;2405;2245;2752;1898;4650;4727
3144508;MG;Nazareno;7240;4121;3832;6048;1905;7953;8710
3144607;MG;Nepomuceno;24822;12814;12907;19921;5800;25721;26882
3144656;MG;Ninheira;9356;5046;4749;2620;7175;9795;10355
3144672;MG;Nova Belém;4495;1896;1836;1348;2384;3732;3067
3144706;MG;Nova Era;17754;8355;9185;15431;2109;17540;17524
3144805;MG;Nova Lima;64387;39272;41890;79394;1768;81162;97378
3144904;MG;Nova Módica;4100;1907;1886;2330;1463;3793;3548
3145000;MG;Nova Ponte;9492;6730;6093;11001;1822;12823;16046
3145059;MG;Nova Porteirinha;7389;3787;3611;4069;3329;7398;7493
3145109;MG;Nova Resende;13887;8105;7268;8857;6516;15373;16937
3145208;MG;Nova Serrana;37447;38091;35628;69711;4008;73719;108241
3145307;MG;Novo Cruzeiro;30453;15258;15468;10523;20203;30726;31339
3145356;MG;Novo Oriente de Minas;9974;5299;5043;4423;5919;10342;10800
3145372;MG;Novorizonte;4610;2485;2468;1717;3236;4953;5348
3145406;MG;Olaria;2304;1063;918;917;1064;1981;1694
3145455;MG;Olhos-dÁgua;4284;2779;2485;2865;2399;5264;6243
3145505;MG;Olímpio Noronha;2247;1304;1229;2249;284;2533;2829
3145604;MG;Oliveira;37250;19306;20163;35188;4281;39469;41987
3145703;MG;Oliveira Fortes;2145;1080;1043;1177;946;2123;2128
3145802;MG;Onça de Pitangui;2985;1625;1572;1519;1678;3197;3155
3145851;MG;Oratórios;4359;2233;2253;3236;1250;4486;4671
3145877;MG;Orizânia;6457;3697;3587;2221;5063;7284;8138
3145901;MG;Ouro Branco;30383;17570;17690;31606;3654;35260;40220
3146008;MG;Ouro Fino;29416;15827;15753;23771;7809;31580;33938
3146107;MG;Ouro Preto;66277;34272;35955;61082;9145;70227;74824
3146206;MG;Ouro Verde de Minas;6223;3023;2998;3624;2397;6021;5895
3146255;MG;Padre Carvalho;5227;2971;2863;3462;2372;5834;6466
3146305;MG;Padre Paraíso;17475;9334;9518;11523;7329;18852;20346
3146404;MG;Paineiras;4895;2332;2299;3598;1033;4631;4440
3146503;MG;Pains;7798;4027;3988;6608;1407;8015;8308
3146552;MG;Pai Pedro;5832;3024;2910;1749;4185;5934;6098
3146602;MG;Paiva;1622;783;777;1221;339;1560;1517
3146701;MG;Palma;6561;3313;3232;5123;1422;6545;6606
3146750;MG;Palmópolis;8886;3564;3361;4488;2437;6925;5196
3146909;MG;Papagaios;12472;7237;6934;11916;2255;14171;15922
3147006;MG;Paracatu;75216;42431;42256;73770;10917;84687;94539
3147105;MG;Pará de Minas;73007;41665;42587;79646;4606;84252;95616
3147204;MG;Paraguaçu;18942;10176;10065;16680;3561;20241;21693
3147303;MG;Paraisópolis;17498;9792;9600;16071;3321;19392;21353
3147402;MG;Paraopeba;20383;11136;11435;19671;2900;22571;24854
3147501;MG;Passabém;1946;864;902;1011;755;1766;1619
3147600;MG;Passa Quatro;14855;7728;7856;11985;3599;15584;16439
3147709;MG;Passa Tempo;8480;4133;4066;6387;1812;8199;8031
3147808;MG;Passa-Vinte;2164;1092;992;1305;779;2084;2024
3147907;MG;Passos;97211;52579;53734;100866;5447;106313;115970
3147956;MG;Patis;5164;2921;2673;2304;3290;5594;6031
3148004;MG;Patos de Minas;123881;67989;70847;127864;10972;138836;154641
3148103;MG;Patrocínio;73130;41979;40562;72822;9719;82541;92116
3148202;MG;Patrocínio do Muriaé;4861;2657;2641;4322;976;5298;5744
3148301;MG;Paula Cândido;9037;4695;4574;4935;4334;9269;9597
3148400;MG;Paulistas;5113;2385;2533;2303;2615;4918;4794
3148509;MG;Pavão;8912;4345;4244;5204;3385;8589;8390
3148608;MG;Peçanha;17183;8530;8740;9105;8165;17270;17534
3148707;MG;Pedra Azul;23608;11749;12094;20997;2846;23843;24333
3148756;MG;Pedra Bonita;6237;3455;3218;1807;4866;6673;7157
3148806;MG;Pedra do Anta;3925;1681;1684;2192;1173;3365;2960
3148905;MG;Pedra do Indaiá;3814;1987;1891;2056;1822;3878;3977
3149002;MG;Pedra Dourada;1822;1136;1051;1297;890;2187;2559
3149101;MG;Pedralva;12009;5858;5609;5563;5904;11467;11098
3149150;MG;Pedras de Maria da Cruz;8871;5291;5019;6323;3987;10310;12313
3149200;MG;Pedrinópolis;3361;1798;1692;2927;563;3490;3651
3149309;MG;Pedro Leopoldo;53957;28729;29967;49939;8757;58696;65149
3149408;MG;Pedro Teixeira;1787;951;838;965;824;1789;1804
3149507;MG;Pequeri;3016;1563;1602;2916;249;3165;3340
3149606;MG;Pequi;3717;2042;2033;2953;1122;4075;4457
3149705;MG;Perdigão;5707;4555;4357;7862;1050;8912;11994
3149804;MG;Perdizes;12364;7530;6861;9955;4436;14391;16469
3149903;MG;Perdões;18736;9898;10242;17817;2323;20140;21577
3149952;MG;Periquito;7445;3450;3580;5283;1747;7030;6738
3150000;MG;Pescador;4037;2047;2082;3260;869;4129;4261
3150109;MG;Piau;3008;1490;1354;1673;1171;2844;2719
3150158;MG;Piedade de Caratinga;5347;3644;3457;4601;2500;7101;8832
3150208;MG;Piedade de Ponte Nova;4029;1992;2071;3179;884;4063;4141
3150307;MG;Piedade do Rio Grande;5063;2386;2323;3477;1232;4709;4436
3150406;MG;Piedade dos Gerais;4274;2418;2227;2122;2523;4645;5034
3150505;MG;Pimenta;7824;4243;3993;6945;1291;8236;8715
3150539;MG;Pingo-dÁgua;3820;2199;2221;4035;385;4420;5029
3150570;MG;Pintópolis;6949;3780;3435;2536;4679;7215;7540
3150604;MG;Piracema;6509;3233;3173;3034;3372;6406;6386
3150703;MG;Pirajuba;2741;2549;2115;4139;525;4664;6491
3150802;MG;Piranga;17010;8647;8583;5957;11273;17230;17641
3150901;MG;Piranguçu;4974;2703;2516;1772;3447;5219;5504
3151008;MG;Piranguinho;7399;4066;3950;4953;3063;8016;8683
3151107;MG;Pirapetinga;10034;5107;5259;9105;1261;10366;10791
3151206;MG;Pirapora;50300;26158;27221;52396;983;53379;56845
3151305;MG;Piraúba;11140;5440;5426;8818;2048;10866;10732
3151404;MG;Pitangui;22269;12553;12786;22638;2701;25339;28433
3151503;MG;Piumhi;28783;15850;16035;28566;3319;31885;35137
3151602;MG;Planura;8297;5458;4935;10100;293;10393;12445
3151701;MG;Poço Fundo;15148;8215;7746;9285;6676;15961;16900
3151800;MG;Poços de Caldas;135627;73681;78815;148785;3711;152496;169838
3151909;MG;Pocrane;9851;4520;4478;5408;3590;8998;8288
3152006;MG;Pompéu;26089;14625;14458;25744;3339;29083;32248
3152105;MG;Ponte Nova;55303;27487;29874;51152;6209;57361;60003
3152131;MG;Ponto Chique;3651;2019;1947;2581;1385;3966;4305
3152170;MG;Ponto dos Volantes;10529;5797;5548;4031;7314;11345;12235
3152204;MG;Porteirinha;37890;18832;18806;19349;18289;37638;37823
3152303;MG;Porto Firme;9474;5303;5107;4832;5578;10410;11414
3152402;MG;Poté;14780;7724;7944;9326;6342;15668;16675
3152501;MG;Pouso Alegre;106776;64461;66125;119602;10984;130586;154293
3152600;MG;Pouso Alto;6669;3134;3079;3658;2555;6213;5862
3152709;MG;Prados;7703;4217;4178;5938;2457;8395;9128
3152808;MG;Prata;23576;13264;12541;19380;6425;25805;28173
3152907;MG;Pratápolis;9217;4456;4352;7794;1014;8808;8530
3153004;MG;Pratinha;2883;1707;1578;1779;1506;3285;3658
3153103;MG;Presidente Bernardes;5847;2780;2757;1642;3895;5537;5315
3153202;MG;Presidente Juscelino;4319;1995;1912;1846;2061;3907;3572
3153301;MG;Presidente Kubitschek;2951;1493;1466;2017;942;2959;3000
3153400;MG;Presidente Olegário;17781;9524;9022;13126;5420;18546;19680
3153509;MG;Alto Jequitibá;8458;4252;4071;4302;4021;8323;8286
3153608;MG;Prudente de Morais;8232;4726;4850;9198;378;9576;10931
3153707;MG;Quartel Geral;3022;1686;1629;2778;537;3315;3603
3153806;MG;Queluzito;1791;957;909;853;1013;1866;1948
3153905;MG;Raposos;14289;7387;7958;14555;790;15345;16501
3154002;MG;Raul Soares;24287;11732;12086;15483;8335;23818;23663
3154101;MG;Recreio;10188;5001;5300;9075;1226;10301;10522
3154150;MG;Reduto;5923;3359;3202;3640;2921;6561;7247
3154200;MG;Resende Costa;10336;5372;5546;8782;2136;10918;11578
3154309;MG;Resplendor;16975;8380;8719;12834;4265;17099;17396
3154408;MG;Ressaquinha;4557;2338;2348;3021;1665;4686;4826
3154457;MG;Riachinho;7973;4182;3825;4435;3572;8007;8132
3154507;MG;Riacho dos Machados;9358;4754;4606;4499;4861;9360;9471
3154606;MG;Ribeirão das Neves;246846;147044;149332;294211;2165;296376;341415
3154705;MG;Ribeirão Vermelho;3621;1842;1984;3543;283;3826;4061
3154804;MG;Rio Acima;7658;4474;4621;7949;1146;9095;10524
3154903;MG;Rio Casca;15260;6846;7352;11334;2864;14198;13384
3155009;MG;Rio Doce;2318;1230;1238;1653;815;2468;2630
3155108;MG;Rio do Prado;5390;2679;2534;2726;2487;5213;5117
3155207;MG;Rio Espera;6942;3070;3008;2411;3667;6078;5332
3155306;MG;Rio Manso;4646;2757;2510;2833;2434;5267;5924
3155405;MG;Rio Novo;8550;4369;4346;7539;1176;8715;8964
3155504;MG;Rio Paranaíba;11528;6097;5801;7301;4597;11898;12356
3155603;MG;Rio Pardo de Minas;27237;14822;14253;11701;17374;29075;31171
3155702;MG;Rio Piracicaba;14138;6908;7259;11284;2883;14167;14325
3155801;MG;Rio Pomba;16359;8506;8617;14445;2678;17123;18007
3155900;MG;Rio Preto;5142;2671;2621;4451;841;5292;5493
3156007;MG;Rio Vermelho;14905;6722;6926;5484;8164;13648;12635
3156106;MG;Ritápolis;5423;2439;2492;3415;1516;4931;4521
3156205;MG;Rochedo de Minas;1907;1086;1030;1914;202;2116;2335
3156304;MG;Rodeiro;5375;3450;3413;5551;1312;6863;8333
3156403;MG;Romaria;3737;1869;1732;2720;881;3601;3507
3156452;MG;Rosário da Limeira;3869;2183;2059;2294;1948;4242;4648
3156502;MG;Rubelita;10199;4000;3777;2516;5261;7777;5609
3156601;MG;Rubim;9666;5044;4864;7700;2208;9908;10269
3156700;MG;Sabará;115352;60772;65447;123042;3177;126219;137877
3156809;MG;Sabinópolis;16269;7775;7932;10134;5573;15707;15364
3156908;MG;Sacramento;21334;12121;11759;19278;4602;23880;26556
3157005;MG;Salinas;36720;19270;19912;30718;8464;39182;41864
3157104;MG;Salto da Divisa;6779;3509;3353;5751;1111;6862;7014
3157203;MG;Santa Bárbara;24180;13663;14187;24771;3079;27850;31873
3157252;MG;Santa Bárbara do Leste;7208;3920;3759;3974;3705;7679;8212
3157278;MG;Santa Bárbara do Monte Verde;2366;1450;1339;1620;1169;2789;3212
3157302;MG;Santa Bárbara do Tugúrio;4827;2337;2266;2195;2408;4603;4385
3157336;MG;Santa Cruz de Minas;7042;3856;4014;7870;0;7870;8723
3157377;MG;Santa Cruz de Salinas;4801;2274;2123;1152;3245;4397;4074
3157401;MG;Santa Cruz do Escalvado;5378;2510;2486;1734;3262;4996;4693
3157500;MG;Santa Efigênia de Minas;4924;2274;2336;3056;1554;4610;4354
3157609;MG;Santa Fé de Minas;4192;2096;1883;2302;1677;3979;3806
3157658;MG;Santa Helena de Minas;5753;3055;3000;3769;2286;6055;6406
3157708;MG;Santa Juliana;8078;5846;5497;9797;1546;11343;14497
3157807;MG;Santa Luzia;184903;98644;104540;202620;564;203184;221705
3157906;MG;Santa Margarida;13713;7583;7428;7626;7385;15011;16393
3158003;MG;Santa Maria de Itabira;10346;5241;5320;6345;4216;10561;10867
3158102;MG;Santa Maria do Salto;5438;2723;2570;3749;1544;5293;5203
3158201;MG;Santa Maria do Suaçuí;14350;7151;7248;10726;3673;14399;14607
3158300;MG;Santana da Vargem;7521;3627;3612;5280;1959;7239;7047
3158409;MG;Santana de Cataguases;3360;1818;1804;2917;705;3622;3909
3158508;MG;Santana de Pirapama;8616;4124;3880;3326;4678;8004;7538
3158607;MG;Santana do Deserto;3774;1943;1911;1405;2449;3854;3985
3158706;MG;Santana do Garambéu;1982;1170;1065;1653;582;2235;2494
3158805;MG;Santana do Jacaré;4408;2321;2292;4434;179;4613;4847
3158904;MG;Santana do Manhuaçu;8607;4403;4200;4154;4449;8603;8660
3158953;MG;Santana do Paraíso;18155;13678;13580;25239;2019;27258;36048
3159001;MG;Santana do Riacho;3739;2017;2006;2279;1744;4023;4334
3159100;MG;Santana dos Montes;3944;1961;1861;2292;1530;3822;3753
3159209;MG;Santa Rita de Caldas;9278;4606;4425;5659;3372;9031;8900
3159308;MG;Santa Rita de Jacutinga;5218;2537;2459;3757;1239;4996;4843
3159357;MG;Santa Rita de Minas;5795;3302;3250;4778;1774;6552;7322
3159407;MG;Santa Rita de Ibitipoca;3847;1846;1737;2233;1350;3583;3380
3159506;MG;Santa Rita do Itueto;6061;2931;2769;2313;3387;5700;5426
3159605;MG;Santa Rita do Sapucaí;31264;18878;18906;32488;5296;37784;44226
3159704;MG;Santa Rosa da Serra;3114;1691;1533;1973;1251;3224;3364
3159803;MG;Santa Vitória;16365;9408;8749;14945;3212;18157;19997
3159902;MG;Santo Antônio do Amparo;16109;8590;8759;15186;2163;17349;18697
3160009;MG;Santo Antônio do Aventureiro;3514;1805;1729;2376;1158;3534;3602
3160108;MG;Santo Antônio do Grama;4377;2034;2056;3365;725;4090;3861
3160207;MG;Santo Antônio do Itambé;4588;2068;2067;1230;2905;4135;3763
3160306;MG;Santo Antônio do Jacinto;12144;6029;5751;6366;5414;11780;11570
3160405;MG;Santo Antônio do Monte;23473;13205;12784;22205;3784;25989;28603
3160454;MG;Santo Antônio do Retiro;6655;3512;3426;1590;5348;6938;7316
3160504;MG;Santo Antônio do Rio Abaixo;1823;889;888;888;889;1777;1756
3160603;MG;Santo Hipólito;3488;1624;1616;2246;994;3240;3044
3160702;MG;Santos Dumont;46789;22493;23796;41330;4959;46289;46357
3160801;MG;São Bento Abade;3737;2385;2192;4238;339;4577;5411
3160900;MG;São Brás do Suaçuí;3282;1730;1782;3128;384;3512;3770
3160959;MG;São Domingos das Dores;5192;2744;2652;2568;2828;5396;5672
3161007;MG;São Domingos do Prata;17642;8438;8914;10506;6846;17352;17296
3161056;MG;São Félix de Minas;3454;1730;1652;2089;1293;3382;3354
3161106;MG;São Francisco;51497;27313;26585;34235;19663;53898;56625
3161205;MG;São Francisco de Paula;6533;3282;3205;4655;1832;6487;6512
3161304;MG;São Francisco de Sales;5274;2980;2820;4338;1462;5800;6309
3161403;MG;São Francisco do Glória;5696;2650;2534;3138;2046;5184;4758
3161502;MG;São Geraldo;7716;5199;5047;7287;2959;10246;12751
3161601;MG;São Geraldo da Piedade;5015;2136;2253;1054;3335;4389;3860
3161650;MG;São Geraldo do Baixio;2864;1762;1725;2440;1047;3487;4104
3161700;MG;São Gonçalo do Abaeté;5432;3234;3018;4174;2078;6252;8527
3161809;MG;São Gonçalo do Pará;7969;5235;5170;7969;2436;10405;12776
3161908;MG;São Gonçalo do Rio Abaixo;8462;4876;4906;4654;5128;9782;11114
3162005;MG;São Gonçalo do Sapucaí;22308;11929;11980;19745;4164;23909;25670
3162104;MG;São Gotardo;27631;16075;15732;30050;1757;31807;36084
3162203;MG;São João Batista do Glória;6271;3559;3331;5610;1280;6890;7541
3162252;MG;São João da Lagoa;4400;2439;2220;2435;2224;4659;4949
3162302;MG;São João da Mata;2752;1400;1332;1752;980;2732;2743
3162401;MG;São João da Ponte;26028;13123;12239;8642;16720;25362;25033
3162450;MG;São João das Missões;10230;6048;5667;2446;9269;11715;13232
3162500;MG;São João del Rei;78616;40494;43910;79790;4614;84404;90897
3162559;MG;São João do Manhuaçu;8716;5214;5031;4806;5439;10245;11785
3162575;MG;São João do Manteninha;4406;2557;2626;2905;2278;5183;5975
3162609;MG;São João do Oriente;8492;3907;3967;6325;1549;7874;7393
3162658;MG;São João do Pacuí;3664;2095;1971;1921;2145;4066;4476
3162708;MG;São João do Paraíso;21010;11173;11161;10239;12095;22334;23797
3162807;MG;São João Evangelista;15526;7599;7939;10108;5430;15538;15761
3162906;MG;São João Nepomuceno;23786;12184;12878;23840;1222;25062;26530
3162922;MG;São Joaquim de Bicas;18152;13756;11863;18652;6967;25619;32696
3162948;MG;São José da Barra;6053;3509;3269;4894;1884;6778;7532
3162955;MG;São José da Lapa;15000;9825;9976;11395;8406;19801;24490
3163003;MG;São José da Safira;3894;2025;2050;2945;1130;4075;4291
3163102;MG;São José da Varginha;3225;2134;2067;2375;1826;4201;5151
3163201;MG;São José do Alegre;3802;1976;2020;2901;1095;3996;4222
3163300;MG;São José do Divino;3863;1890;1947;2728;1109;3837;3851
3163409;MG;São José do Goiabal;6009;2732;2904;3689;1947;5636;5356
3163508;MG;São José do Jacuri;6789;3331;3222;2006;4547;6553;6409
3163607;MG;São José do Mantimento;2379;1289;1303;1445;1147;2592;2821
3163706;MG;São Lourenço;36927;19764;21900;41664;0;41664;46539
3163805;MG;São Miguel do Anta;6641;3433;3317;3742;3008;6750;6949
3163904;MG;São Pedro da União;5618;2647;2393;2781;2259;5040;4563
3164001;MG;São Pedro dos Ferros;9239;4125;4228;6780;1573;8353;7634
3164100;MG;São Pedro do Suaçuí;6081;2746;2824;2302;3268;5570;5160
3164209;MG;São Romão;7783;5236;5049;6476;3809;10285;12713
3164308;MG;São Roque de Minas;6325;3483;3203;4222;2464;6686;7100
3164407;MG;São Sebastião da Bela Vista;4311;2578;2370;2889;2059;4948;5598
3164431;MG;São Sebastião da Vargem Alegre;2573;1459;1339;1603;1195;2798;3039
3164472;MG;São Sebastião do Anta;4779;2926;2813;4209;1530;5739;6697
3164506;MG;São Sebastião do Maranhão;11604;5371;5276;3250;7397;10647;9884
3164605;MG;São Sebastião do Oeste;4648;3030;2775;3247;2558;5805;6948
3164704;MG;São Sebastião do Paraíso;58335;32207;32827;59994;5040;65034;71915
3164803;MG;São Sebastião do Rio Preto;1779;774;842;876;740;1616;1478
3164902;MG;São Sebastião do Rio Verde;1976;1048;1062;1321;789;2110;2259
3165008;MG;São Tiago;10245;5291;5262;8467;2086;10553;10979
3165107;MG;São Tomás de Aquino;7303;3558;3535;5522;1571;7093;6980
3165206;MG;São Tomé das Letras;6204;3539;3116;3857;2798;6655;7151
3165305;MG;São Vicente de Minas;6163;3394;3614;5940;1068;7008;7876
3165404;MG;Sapucaí-Mirim;5455;3203;3038;3783;2458;6241;7045
3165503;MG;Sardoá;4775;2813;2784;2000;3597;5597;6421
3165537;MG;Sarzedo;17274;12869;12929;25516;282;25798;34050
3165552;MG;Setubinha;9291;5350;5535;2802;8083;10885;12493
3165560;MG;Sem-Peixe;3170;1404;1443;1507;1340;2847;2579
3165578;MG;Senador Amaral;5128;2779;2446;3107;2118;5225;5365
3165602;MG;Senador Cortes;2000;980;1000;1512;468;1980;2001
3165701;MG;Senador Firmino;6598;3653;3577;4683;2547;7230;7902
3165800;MG;Senador José Bento;2371;1005;863;683;1185;1868;1422
3165909;MG;Senador Modestino Gonçalves;5190;2315;2259;1803;2771;4574;4056
3166006;MG;Senhora de Oliveira;5643;2852;2837;3262;2427;5689;5786
3166105;MG;Senhora do Porto;3520;1766;1727;1284;2209;3493;3516
3166204;MG;Senhora dos Remédios;10024;5155;5047;3435;6767;10202;10474
3166303;MG;Sericita;6990;3644;3481;3718;3407;7125;7340
3166402;MG;Seritinga;1738;917;873;1483;307;1790;1857
3166501;MG;Serra Azul de Minas;4197;2121;2099;1710;2510;4220;4292
3166600;MG;Serra da Saudade;873;431;384;527;288;815;771
3166709;MG;Serra dos Aimorés;8182;4174;4245;6780;1639;8419;8725
3166808;MG;Serra do Salitre;9390;5412;5129;7751;2790;10541;11750
3166907;MG;Serrania;7504;3803;3737;6574;966;7540;7667
3166956;MG;Serranópolis de Minas;4038;2231;2194;1728;2697;4425;4836
3167004;MG;Serranos;2071;1001;995;1543;453;1996;1949
3167103;MG;Serro;21012;10367;10466;12895;7938;20833;20915
3167202;MG;Sete Lagoas;184871;103912;110159;208879;5192;214071;243950
3167301;MG;Silveirânia;2138;1148;1044;1429;763;2192;2267
3167400;MG;Silvianópolis;5855;3129;2900;3647;2382;6029;6258
3167509;MG;Simão Pereira;2479;1247;1290;1496;1041;2537;2621
3167608;MG;Simonésia;16875;9460;8842;7114;11188;18302;19834
3167707;MG;Sobrália;6284;2855;2973;4126;1702;5828;5476
3167806;MG;Soledade de Minas;5155;2842;2836;3765;1913;5678;6226
3167905;MG;Tabuleiro;4572;2045;2031;2701;1375;4076;3669
3168002;MG;Taiobeiras;27347;15108;15786;25042;5852;30894;34653
3168051;MG;Taparuba;3225;1616;1521;1405;1732;3137;3093
3168101;MG;Tapira;3327;2205;1897;2744;1358;4102;4890
3168200;MG;Tapiraí;1900;1002;871;1085;788;1873;1869
3168309;MG;Taquaraçu de Minas;3491;2026;1766;1753;2039;3792;4120
3168408;MG;Tarumirim;14488;7102;7192;8019;6275;14294;14280
3168507;MG;Teixeiras;11149;5538;5808;7605;3741;11346;11680
3168606;MG;Teófilo Otoni;129424;64447;70286;110059;24674;134733;141269
3168705;MG;Timóteo;71478;39129;41990;81003;116;81119;91268
3168804;MG;Tiradentes;5759;3458;3544;5404;1598;7002;8160
3168903;MG;Tiros;7571;3537;3369;4815;2091;6906;6369
3169000;MG;Tocantins;15005;7906;7933;12926;2913;15839;16769
3169059;MG;Tocos do Moji;3821;2145;1805;1018;2932;3950;4117
3169109;MG;Toledo;5222;3039;2722;2190;3571;5761;6336
3169208;MG;Tombos;11652;4786;4756;7607;1935;9542;7683
3169307;MG;Três Corações;65291;36115;36681;65851;6945;72796;80561
3169356;MG;Três Marias;23568;14074;14241;26838;1477;28315;33062
3169406;MG;Três Pontas;51024;26688;27137;46242;7583;53825;57127
3169505;MG;Tumiritinga;5831;3196;3095;4323;1968;6291;6797
3169604;MG;Tupaciguara;23117;12083;12102;22045;2140;24185;25466
3169703;MG;Turmalina;15655;9161;8885;12913;5133;18046;20280
3169802;MG;Turvolândia;4243;2410;2248;2910;1748;4658;5099
3169901;MG;Ubá;85065;50246;51220;97599;3867;101466;117995
3170008;MG;Ubaí;10774;5978;5699;5665;6012;11677;12661
3170057;MG;Ubaporanga;11682;6085;5955;6434;5606;12040;12514
3170107;MG;Uberaba;252051;144473;151527;289408;6592;296000;340277
3170206;MG;Uberlândia;501214;293115;307170;583879;16406;600285;706597
3170305;MG;Umburatiba;2872;1394;1306;1552;1148;2700;2582
3170404;MG;Unaí;70033;39305;38285;62364;15226;77590;85461
3170438;MG;União de Minas;4638;2415;2009;2731;1693;4424;4265
3170479;MG;Uruana de Minas;3263;1627;1611;1821;1417;3238;3256
3170503;MG;Urucânia;10375;5085;5206;7946;2345;10291;10333
3170529;MG;Urucuia;9615;7031;6574;6166;7439;13605;17470
3170578;MG;Vargem Alegre;6544;3290;3167;4769;1688;6457;6460
3170602;MG;Vargem Bonita;2212;1145;1018;1142;1021;2163;2143
3170651;MG;Vargem Grande do Rio Pardo;4457;2428;2305;2421;2312;4733;5045
3170701;MG;Varginha;108998;59975;63145;119099;4021;123120;137608
3170750;MG;Varjão de Minas;4701;3181;2884;5030;1035;6065;7235
3170800;MG;Várzea da Palma;31641;18144;17660;31317;4487;35804;40101
3170909;MG;Varzelândia;19169;9769;9357;8906;10220;19126;19290
3171006;MG;Vazante;18928;9928;9793;15924;3797;19721;20692
3171030;MG;Verdelândia;7179;4276;4074;4764;3586;8350;9527
3171071;MG;Veredinha;5257;2879;2654;3757;1776;5533;5733
3171105;MG;Veríssimo;2874;1776;1690;2037;1429;3466;4090
3171154;MG;Vermelho Novo;4572;2428;2261;1852;2837;4689;4852
3171204;MG;Vespasiano;76422;51095;53517;104612;0;104612;131849
3171303;MG;Viçosa;64854;34988;37256;67337;4907;72244;79910
3171402;MG;Vieiras;3952;1897;1835;1854;1878;3732;3570
3171501;MG;Mathias Lobato;3642;1676;1695;3058;313;3371;3157
3171600;MG;Virgem da Lapa;13672;6757;6868;6842;6783;13625;13729
3171709;MG;Virgínia;8699;4308;4318;3936;4690;8626;8652
3171808;MG;Virginópolis;10827;5212;5360;6210;4362;10572;10459
3171907;MG;Virgolândia;6112;2790;2869;3400;2259;5659;5303
3172004;MG;Visconde do Rio Branco;32598;18702;19250;31397;6555;37952;43351
3172103;MG;Volta Grande;4919;2470;2593;3802;1261;5063;5270
3172202;MG;Wenceslau Braz;2596;1288;1265;1270;1283;2553;2543
3200102;ES;Afonso Cláudio;32232;15684;15402;15861;15225;31086;30326
3200136;ES;Águia Branca;9599;4900;4617;3051;6466;9517;9621
3200169;ES;Água Doce do Norte;12751;5956;5815;6699;5072;11771;10801
3200201;ES;Alegre;31714;15288;15496;21521;9263;30784;29869
3200300;ES;Alfredo Chaves;13616;7107;6853;6557;7403;13960;14670
3200359;ES;Alto Rio Novo;6964;3658;3645;4239;3064;7303;7911
3200409;ES;Anchieta;19176;12057;11837;18153;5741;23894;30285
3200508;ES;Apiacá;7615;3779;3734;5212;2301;7513;7542
3200607;ES;Aracruz;64637;40768;40978;71407;10339;81746;104942
3200706;ES;Atilio Vivacqua;8327;4990;4850;6114;3726;9840;12270
3200805;ES;Baixo Guandu;27819;14220;14866;22519;6567;29086;31263
3200904;ES;Barra de São Francisco;37597;20373;20237;26340;14270;40610;45301
3201001;ES;Boa Esperança;13679;7180;7019;10239;3960;14199;15146
3201100;ES;Bom Jesus do Norte;9226;4582;4897;8702;777;9479;9988
3201159;ES;Brejetuba;11687;6217;5704;3417;8504;11921;12450
3201209;ES;Cachoeiro de Itapemirim;174879;92751;97127;173572;16306;189878;212172
3201308;ES;Cariacica;324285;169982;178951;337822;11111;348933;386495
3201407;ES;Castelo;32756;17429;17397;21879;12947;34826;37956
3201506;ES;Colatina;112711;54303;57491;98395;13399;111794;124283
3201605;ES;Conceição da Barra;26494;14178;14299;22591;5886;28477;31479
3201704;ES;Conceição do Castelo;10910;5941;5745;5902;5784;11686;12887
3201803;ES;Divino de São Lourenço;4817;2351;2164;1742;2773;4515;4236
3201902;ES;Domingos Martins;30559;16068;15756;7741;24083;31824;34120
3202009;ES;Dores do Rio Preto;6188;3222;3177;3542;2857;6399;6793
3202108;ES;Ecoporanga;23979;11566;11657;14776;8447;23223;22748
3202207;ES;Fundão;13009;8493;8535;14382;2646;17028;22379
3202256;ES;Governador Lindenberg;0;5673;5201;4234;6640;10874;13047
3202306;ES;Guaçuí;25492;13686;14167;22403;5450;27853;31372
3202405;ES;Guarapari;88400;51424;53803;100268;4959;105227;128504
3202454;ES;Ibatiba;19210;11293;11053;13358;8988;22346;26762
3202504;ES;Ibiraçu;10143;5518;5640;8451;2707;11158;12701
3202553;ES;Ibitirama;9211;4657;4307;3179;5785;8964;8830
3202603;ES;Iconha;11481;6410;6104;7273;5241;12514;14083
3202652;ES;Irupi;10354;6032;5697;4440;7289;11729;13672
3202702;ES;Itaguaçu;14495;7197;6937;8054;6080;14134;13982
3202801;ES;Itapemirim;28121;15537;15451;19325;11663;30988;34957
3202900;ES;Itarana;11425;5455;5426;4095;6786;10881;10433
3203007;ES;Iúna;26112;13649;13691;15640;11700;27340;29417
3203056;ES;Jaguaré;19539;12486;12232;15056;9662;24718;31589
3203106;ES;Jerônimo Monteiro;10189;5298;5590;8540;2348;10888;12336
3203130;ES;João Neiva;15301;7805;8003;12755;3053;15808;16774
3203163;ES;Laranja da Terra;10934;5523;5302;3527;7298;10825;10919
3203205;ES;Linhares;112617;70366;70888;121503;19751;141254;179755
3203304;ES;Mantenópolis;12201;6816;6784;8653;4947;13600;15653
3203320;ES;Marataízes;30603;16880;17267;27619;6528;34147;39259
3203346;ES;Marechal Floriano;12188;7251;6998;7408;6841;14249;17141
3203353;ES;Marilândia;9924;5572;5535;5648;5459;11107;13091
3203403;ES;Mimoso do Sul;26199;13039;12859;16226;9672;25898;26079
3203502;ES;Montanha;17263;8977;8877;13525;4329;17854;18954
3203601;ES;Mucurici;5900;2877;2795;3599;2073;5672;5468
3203700;ES;Muniz Freire;19689;9305;9082;8669;9718;18387;17176
3203809;ES;Muqui;13670;7255;7141;9309;5087;14396;15602
3203908;ES;Nova Venécia;43015;23111;22909;30824;15196;46020;50751
3204005;ES;Pancas;20402;10995;10525;10082;11438;21520;23426
3204054;ES;Pedro Canário;21961;11900;11889;22052;1737;23789;26575
3204104;ES;Pinheiros;21320;12002;11889;18714;5177;23891;27601
3204203;ES;Piúma;14987;8950;9173;17450;673;18123;22388
3204252;ES;Ponto Belo;6263;3493;3486;5588;1391;6979;8016
3204302;ES;Presidente Kennedy;9555;5253;5062;3440;6875;10315;11741
3204351;ES;Rio Bananal;16324;9076;8462;6796;10742;17538;19398
3204401;ES;Rio Novo do Sul;11271;5748;5585;5950;5383;11333;11630
3204500;ES;Santa Leopoldina;12463;6437;5818;2634;9621;12255;12171
3204559;ES;Santa Maria de Jetibá;28774;17534;16644;11791;22387;34178;41588
3204609;ES;Santa Teresa;20622;10908;10907;11763;10052;21815;23853
3204658;ES;São Domingos do Norte;7547;4172;3844;3439;4577;8016;8735
3204708;ES;São Gabriel da Palha;26588;15902;15957;24327;7532;31859;39085
3204807;ES;São José do Calçado;10481;5200;5217;8358;2059;10417;10536
3204906;ES;São Mateus;90460;53964;55103;84586;24481;109067;134629
3204955;ES;São Roque do Canaã;10395;5695;5592;5597;5690;11287;12602
3205002;ES;Serra;321181;201407;207917;406517;2807;409324;536765
3205010;ES;Sooretama;18269;12142;11718;16882;6978;23860;31278
3205036;ES;Vargem Alta;17376;9832;9309;6724;12417;19141;21778
3205069;ES;Venda Nova do Imigrante;16165;10345;10123;14812;5656;20468;26204
3205101;ES;Viana;53452;33167;31832;59640;5359;64999;80735
3205150;ES;Vila Pavão;8330;4493;4179;2998;5674;8672;9280
3205176;ES;Vila Valério;13875;7207;6623;5042;8788;13830;14065
3205200;ES;Vila Velha;345965;199083;215337;412402;2018;414420;508655
3205309;ES;Vitória;292304;152630;172823;325453;0;325453;369534
3300100;RJ;Angra dos Reis;119247;84490;84780;163080;6190;169270;210171
3300159;RJ;Aperibé;8018;5023;5192;8880;1335;10215;12036
3300209;RJ;Araruama;82803;54305;57723;106519;5509;112028;136109
3300225;RJ;Areal;9899;5663;5758;9920;1501;11421;12763
3300233;RJ;Armação dos Búzios;18204;13737;13801;27538;0;27538;35060
3300258;RJ;Arraial do Cabo;23877;13647;14123;27770;0;27770;30827
3300308;RJ;Barra do Piraí;88503;45208;49647;92040;2815;94855;101139
3300407;RJ;Barra Mansa;170753;85822;92039;176251;1610;177861;185237
3300456;RJ;Belford Roxo;434474;226757;242504;469261;0;469261;515239
3300506;RJ;Bom Jardim;22651;12756;12642;15281;10117;25398;27779
3300605;RJ;Bom Jesus do Itabapoana;33655;17179;18205;29912;5472;35384;37306
3300704;RJ;Cabo Frio;126828;90806;95416;140466;45756;186222;234077
3300803;RJ;Cachoeiras de Macacu;48543;27127;27243;47015;7355;54370;59652
3300902;RJ;Cambuci;14670;7402;7427;11301;3528;14829;15521
3300936;RJ;Carapebus;8666;6792;6556;10542;2806;13348;16859
3300951;RJ;Comendador Levy Gasparian;7924;4080;4103;7865;318;8183;8590
3301009;RJ;Campos dos Goytacazes;406989;223100;240445;418565;44980;463545;514643
3301108;RJ;Cantagalo;19835;9840;9986;14027;5799;19826;20163
3301157;RJ;Cardoso Moreira;12595;6243;6297;8764;3776;12540;12818
3301207;RJ;Carmo;15289;8603;8836;13474;3965;17439;19161
3301306;RJ;Casimiro de Abreu;22152;17436;17937;28533;6840;35373;45864
3301405;RJ;Conceição de Macabu;18782;10543;10657;18332;2868;21200;23561
3301504;RJ;Cordeiro;18601;9761;10642;19835;568;20403;22152
3301603;RJ;Duas Barras;10334;5512;5421;7739;3194;10933;11563
3301702;RJ;Duque de Caxias;775456;410959;444087;852131;2915;855046;929449
3301801;RJ;Engenheiro Paulo de Frontin;12164;6451;6788;9525;3714;13239;14138
3301850;RJ;Guapimirim;37952;25289;26198;49757;1730;51487;62225
3301876;RJ;Iguaba Grande;15089;11044;11814;22858;0;22858;29344
3301900;RJ;Itaboraí;187479;106214;111876;215503;2587;218090;244416
3302007;RJ;Itaguaí;82003;54426;54737;104292;4871;109163;136547
3302056;RJ;Italva;12621;6834;7193;10228;3799;14027;15387
3302106;RJ;Itaocara;23003;11193;11709;17329;5573;22902;23211
3302205;RJ;Itaperuna;86720;46541;49335;88408;7468;95876;104354
3302254;RJ;Itatiaia;24739;14248;14604;27848;1004;28852;32312
3302270;RJ;Japeri;83278;48058;47333;95391;0;95391;106296
3302304;RJ;Laje do Muriaé;7909;3754;3737;5636;1855;7491;7298
3302403;RJ;Macaé;132461;102471;104277;202873;3875;206748;266136
3302452;RJ;Macuco;4886;2528;2741;4593;676;5269;5646
3302502;RJ;Magé;205830;110970;117180;215941;12209;228150;247741
3302601;RJ;Mangaratiba;24901;17876;18435;31989;4322;36311;45941
3302700;RJ;Maricá;76737;62695;64824;125532;1987;127519;167668
3302809;RJ;Mendes;17289;8657;9283;17706;234;17940;18681
3302858;RJ;Mesquita;0;79775;88628;168403;0;168403;177016
3302908;RJ;Miguel Pereira;23902;11727;12920;21508;3139;24647;25622
3303005;RJ;Miracema;27064;13015;13814;24701;2128;26829;27134
3303104;RJ;Natividade;15125;7441;7636;12041;3036;15077;15305
3303203;RJ;Nilópolis;153712;73714;83769;157483;0;157483;162893
3303302;RJ;Niterói;459451;225671;261656;487327;0;487327;516981
3303401;RJ;Nova Friburgo;173418;87242;94774;159335;22681;182016;191664
3303500;RJ;Nova Iguaçu;920599;381198;414014;786536;8676;795212;825388
3303609;RJ;Paracambi;40475;23753;23321;41677;5397;47074;53093
3303708;RJ;Paraíba do Sul;37410;19770;21318;36159;4929;41088;44741
3303807;RJ;Paraty;29544;18992;18583;27717;9858;37575;44175
3303856;RJ;Paty do Alferes;24931;12819;13562;18607;7774;26381;27942
3303906;RJ;Petrópolis;286537;141079;154965;281356;14688;296044;307144
3303955;RJ;Pinheiral;19481;11036;11688;20414;2310;22724;25563
3304003;RJ;Piraí;22118;12920;13389;20831;5478;26309;29802
3304102;RJ;Porciúncula;15952;8873;8898;13902;3869;17771;19068
3304110;RJ;Porto Real;12095;8232;8342;16481;93;16574;20254
3304128;RJ;Quatis;10730;6261;6570;12067;764;12831;14562
3304144;RJ;Queimados;121993;66621;71317;137938;0;137938;152311
3304151;RJ;Quissamã;13674;10036;10208;13016;7228;20244;25535
3304201;RJ;Resende;104549;58244;61557;112375;7426;119801;133244
3304300;RJ;Rio Bonito;49691;27349;28237;41267;14319;55586;60930
3304409;RJ;Rio Claro;16228;8747;8654;13754;3647;17401;18677
3304508;RJ;Rio das Flores;7625;4201;4344;5948;2597;8545;9401
3304524;RJ;Rio das Ostras;36419;52240;53517;99999;5758;105757;159529
3304557;RJ;Rio de Janeiro;5857904;2960954;3362083;6323037;0;6323037;6775561
3304607;RJ;Santa Maria Madalena;10476;5275;5046;5932;4389;10321;10380
3304706;RJ;Santo Antônio de Pádua;38692;19946;20623;31086;9483;40569;42705
3304755;RJ;São Francisco de Itabapoana;41145;20802;20555;21090;20267;41357;42214
3304805;RJ;São Fidélis;36789;18402;19151;29689;7864;37553;38749
3304904;RJ;São Gonçalo;891119;475336;524565;999161;740;999901;1098357
3305000;RJ;São João da Barra;27682;16234;16533;25715;7052;32767;36731
3305109;RJ;São João de Meriti;449476;218391;240965;459356;0;459356;473385
3305133;RJ;São José de Ubá;6413;3498;3505;3098;3905;7003;7240
3305158;RJ;São José do Vale do Rio Preto;19278;10147;10105;9005;11247;20252;22032
3305208;RJ;São Pedro da Aldeia;63227;43495;44518;82286;5727;88013;107556
3305307;RJ;São Sebastião do Alto;8402;4474;4432;4623;4283;8906;9416
3305406;RJ;Sapucaia;17157;8763;8741;13247;4257;17504;18270
3305505;RJ;Saquarema;52461;36846;37375;70448;3773;74221;91938
3305554;RJ;Seropédica;65260;38400;39783;64297;13886;78183;83841
3305604;RJ;Silva Jardim;21265;10810;10550;16126;5234;21360;21775
3305703;RJ;Sumidouro;14176;7657;7263;5458;9462;14920;15709
3305752;RJ;Tanguá;26057;15284;15447;27426;3305;30731;34898
3305802;RJ;Teresópolis;138081;78249;85556;145473;18332;163805;185820
3305901;RJ;Trajano de Moraes;10038;5260;5021;4776;5505;10281;10653
3306008;RJ;Três Rios;71976;37068;40435;75233;2270;77503;82468
3306107;RJ;Valença;66308;34474;37420;62266;9628;71894;77202
3306156;RJ;Varre-Sai;7854;4778;4725;5805;3698;9503;11208
3306206;RJ;Vassouras;31451;16404;18035;23192;11247;34439;37262
3306305;RJ;Volta Redonda;242063;122977;135019;257879;117;257996;274925
3500105;SP;Adamantina;33497;16375;17422;31948;1849;33797;35153
3500204;SP;Adolfo;3684;1787;1770;3200;357;3557;3545
3500303;SP;Aguaí;28195;16224;15944;29021;3147;32168;36981
3500402;SP;Águas da Prata;7131;3742;3838;6766;814;7580;8262
3500501;SP;Águas de Lindóia;16190;8453;8808;17108;153;17261;18908
3500550;SP;Águas de Santa Bárbara;5224;2777;2821;4256;1342;5598;6142
3500600;SP;Águas de São Pedro;1883;1257;1446;2703;0;2703;3588
3500709;SP;Agudos;32484;17086;17446;32999;1533;34532;37582
3500758;SP;Alambari;3650;2457;2429;3672;1214;4886;6231
3500808;SP;Alfredo Marcondes;3697;1980;1911;3255;636;3891;4201
3500907;SP;Altair;3530;2051;1763;3022;792;3814;4211
3501004;SP;Altinópolis;15481;7802;7807;13643;1966;15609;16221
3501103;SP;Alto Alegre;4261;2109;1996;3237;868;4105;4078
3501152;SP;Alumínio;15252;8502;8343;14130;2715;16845;18903
3501202;SP;Álvares Florence;4316;2001;1900;2652;1249;3901;3616
3501301;SP;Álvares Machado;22661;11633;11873;21180;2326;23506;25078
3501400;SP;Álvaro de Carvalho;4109;2959;1691;2952;1698;4650;5320
3501509;SP;Alvinlândia;2837;1482;1518;2693;307;3000;3251
3501608;SP;Americana;182593;103200;107501;209717;984;210701;244370
3501707;SP;Américo Brasiliense;28287;17362;17160;34261;261;34522;41545
3501806;SP;Américo de Campos;5594;2862;2844;4788;918;5706;5993
3501905;SP;Amparo;60404;32444;33392;51818;14018;65836;73145
3502002;SP;Analândia;3582;2197;2092;3401;888;4289;5115
3502101;SP;Andradina;55161;27185;28132;51629;3688;55317;57245
3502200;SP;Angatuba;19297;11246;10965;15954;6257;22211;25724
3502309;SP;Anhembi;4535;2908;2740;4263;1385;5648;6911
3502408;SP;Anhumas;3411;1863;1875;3059;679;3738;4172
3502507;SP;Aparecida;34904;16918;18125;34534;509;35043;36211
3502606;SP;Aparecida dOeste;4935;2174;2270;3639;805;4444;4122
3502705;SP;Apiaí;27162;12579;12617;18226;6970;25196;24081
3502754;SP;Araçariguama;11154;8705;8380;11284;5801;17085;23343
3502804;SP;Araçatuba;169254;87337;94281;178118;3500;181618;199210
3502903;SP;Araçoiaba da Serra;19816;13601;13722;18807;8516;27323;35389
3503000;SP;Aramina;4763;2587;2563;4811;339;5150;5689
3503109;SP;Arandu;6065;3088;3035;4614;1509;6123;6373
3503158;SP;Arapeí;2618;1254;1238;1874;618;2492;2452
3503208;SP;Araraquara;182471;100733;107992;202802;5923;208725;240542
3503307;SP;Araras;104196;58729;60169;112497;6401;118898;136739
3503356;SP;Arco-Íris;2163;971;954;1097;828;1925;1755
3503406;SP;Arealva;7244;3997;3845;6177;1665;7842;8665
3503505;SP;Areias;3600;1829;1864;2475;1218;3693;3906
3503604;SP;Areiópolis;10296;5454;5127;9403;1178;10581;11186
3503703;SP;Ariranha;7477;4366;4181;8094;453;8547;9851
3503802;SP;Artur Nogueira;33124;22123;22147;40026;4244;44270;56247
3503901;SP;Arujá;59185;36924;37894;71828;2990;74818;92453
3503950;SP;Aspásia;1861;907;902;1257;552;1809;1815
3504008;SP;Assis;87251;46318;48838;91001;4155;95156;105768
3504107;SP;Atibaia;111300;62217;64397;115266;11348;126614;145378
3504206;SP;Auriflama;13513;7104;7101;12950;1255;14205;15316
3504305;SP;Avaí;4596;2506;2453;3330;1629;4959;5467
3504404;SP;Avanhandava;8829;6250;5061;9563;1748;11311;14063
3504503;SP;Avaré;76472;41134;41801;79392;3543;82935;91792
3504602;SP;Bady Bassitt;11550;7250;7355;13661;944;14605;18013
3504701;SP;Balbinos;1313;3232;700;1191;2741;3932;6127
3504800;SP;Bálsamo;7340;3998;4162;7474;686;8160;9209
3504909;SP;Bananal;9713;5052;5168;8157;2063;10220;11039
3505005;SP;Barão de Antonina;2794;1591;1525;1913;1203;3116;3525
3505104;SP;Barbosa;5837;3323;3270;5575;1018;6593;7532
3505203;SP;Bariri;28224;15822;15781;29985;1618;31603;35844
3505302;SP;Barra Bonita;35487;17256;18000;34517;739;35256;36125
3505351;SP;Barra do Chapéu;4846;2766;2470;1544;3692;5236;5794
3505401;SP;Barra do Turvo;8108;4050;3679;3174;4555;7729;7606
3505500;SP;Barretos;103913;54169;57933;108687;3415;112102;123546
3505609;SP;Barrinha;24207;14327;14176;28187;316;28503;33537
3505708;SP;Barueri;208281;116977;123679;240656;0;240656;279704
3505807;SP;Bastos;20588;10040;10421;17624;2837;20461;20952
3505906;SP;Batatais;51112;27749;28732;49954;6527;56481;63438
3506003;SP;Bauru;316064;166692;177347;338891;5148;344039;381706
3506102;SP;Bebedouro;74815;36531;38513;71512;3532;75044;77612
3506201;SP;Bento de Abreu;2394;1364;1310;2444;230;2674;3028
3506300;SP;Bernardino de Campos;10720;5251;5526;9660;1117;10777;11168
3506359;SP;Bertioga;30039;23769;23803;46818;754;47572;66154
3506409;SP;Bilac;6088;3493;3559;6485;567;7052;8197
3506508;SP;Birigui;94300;53086;55636;105481;3241;108722;126094
3506607;SP;Biritiba-Mirim;24653;14412;14161;24530;4043;28573;33265
3506706;SP;Boa Esperança do Sul;12573;6884;6774;12197;1461;13658;15111
3506805;SP;Bocaina;9442;5411;5451;10009;853;10862;12571
3506904;SP;Bofete;7356;4731;4551;6121;3161;9282;12107
3507001;SP;Boituva;34368;24319;24004;45457;2866;48323;63310
3507100;SP;Bom Jesus dos Perdões;13313;9914;9789;17386;2317;19703;26506
3507159;SP;Bom Sucesso de Itararé;3231;1815;1756;2430;1141;3571;4013
3507209;SP;Borá;795;422;383;627;178;805;839
3507308;SP;Boracéia;3739;2178;2090;3827;441;4268;4913
3507407;SP;Borborema;13193;7352;7180;13098;1434;14532;16278
3507456;SP;Borebi;1933;1144;1151;2002;293;2295;2713
3507506;SP;Botucatu;108306;61789;65581;122718;4652;127370;149718
3507605;SP;Bragança Paulista;125031;72034;74629;142174;4489;146663;172346
3507704;SP;Braúna;4383;2552;2469;4390;631;5021;5795
3507753;SP;Brejo Alegre;2308;1330;1243;2110;463;2573;2911
3507803;SP;Brodowski;17139;10466;10639;20596;509;21105;25605
3507902;SP;Brotas;18886;10711;10869;18599;2981;21580;24862
3508009;SP;Buri;17629;9502;9064;14995;3571;18566;20050
3508108;SP;Buritama;13854;7732;7686;14526;892;15418;17414
3508207;SP;Buritizal;3674;2074;1981;3310;745;4055;4547
3508306;SP;Cabrália Paulista;4656;2220;2145;3777;588;4365;4222
3508405;SP;Cabreúva;33100;21114;20529;35295;6348;41643;51130
3508504;SP;Caçapava;76130;42040;42804;72619;12225;84844;95752
3508603;SP;Cachoeira Paulista;27205;14748;15351;24580;5519;30099;33827
3508702;SP;Caconde;18378;9285;9251;12633;5903;18536;19031
3508801;SP;Cafelândia;15793;8176;8436;14423;2189;16612;17917
3508900;SP;Caiabu;4077;2091;1981;3315;757;4072;4195
3509007;SP;Caieiras;71221;42354;44269;84476;2147;86623;104044
3509106;SP;Caiuá;4192;2652;2387;1930;3109;5039;6017
3509205;SP;Cajamar;50761;32005;32108;62822;1291;64113;79034
3509254;SP;Cajati;29227;14329;14042;20719;7652;28371;28441
3509304;SP;Cajobi;9174;5014;4745;9124;635;9759;10649
3509403;SP;Cajuru;20777;11700;11678;20802;2576;23378;26613
3509452;SP;Campina do Monte Alegre;5209;2853;2714;4710;857;5567;6088
3509502;SP;Campinas;969396;521209;559790;1062453;18546;1080999;1223237
3509601;SP;Campo Limpo Paulista;63724;36423;37691;74114;0;74114;86407
3509700;SP;Campos do Jordão;44252;23413;24411;47526;298;47824;52713
3509809;SP;Campos Novos Paulista;4181;2339;2200;3528;1011;4539;5028
3509908;SP;Cananéia;12298;6134;6092;10436;1790;12226;12542
3509957;SP;Canas;3614;2224;2163;4072;315;4387;5268
3510005;SP;Cândido Mota;29280;14674;15237;28122;1789;29911;31410
3510104;SP;Cândido Rodrigues;2613;1315;1353;2153;515;2668;2805
3510153;SP;Canitar;3481;2216;2153;4138;231;4369;5365
3510203;SP;Capão Bonito;46732;23020;23158;37824;8354;46178;47098
3510302;SP;Capela do Alto;14247;9037;8496;14523;3010;17533;21257
3510401;SP;Capivari;41468;24359;24214;45901;2672;48573;56973
3510500;SP;Caraguatatuba;78921;49984;50915;97449;3450;100899;125194
3510609;SP;Carapicuíba;344596;179353;190555;369908;0;369908;405375
3510708;SP;Cardoso;11605;5828;5970;10723;1075;11798;12371
3510807;SP;Casa Branca;26800;14998;13314;23156;5156;28312;30655
3510906;SP;Cássia dos Coqueiros;2871;1332;1295;1790;837;2627;2488
3511003;SP;Castilho;14948;8975;9031;13592;4414;18006;21521
3511102;SP;Catanduva;105847;54777;58066;111937;906;112843;123114
3511201;SP;Catiguá;6555;3633;3494;6569;558;7127;7905
3511300;SP;Cedral;6700;3974;3994;6303;1665;7968;9452
3511409;SP;Cerqueira César;15144;8673;8859;15716;1816;17532;20391
3511508;SP;Cerquilho;29508;19653;19996;37599;2050;39649;50631
3511607;SP;Cesário Lange;12883;8059;7488;10495;5052;15547;18595
3511706;SP;Charqueada;13037;7684;7402;13689;1397;15086;17539
3511904;SP;Clementina;5404;3661;3403;6733;331;7064;8894
3512001;SP;Colina;16664;8629;8744;16225;1148;17373;18601
3512100;SP;Colômbia;5954;3066;2928;4332;1662;5994;6223
3512209;SP;Conchal;22676;12765;12477;23858;1384;25242;28491
3512308;SP;Conchas;14904;8183;8119;13203;3099;16302;18138
3512407;SP;Cordeirópolis;17591;10599;10486;18936;2149;21085;25116
3512506;SP;Coroados;4417;2610;2628;4242;996;5238;6197
3512605;SP;Coronel Macedo;5589;2565;2436;3865;1136;5001;4591
3512704;SP;Corumbataí;3794;1974;1900;2093;1781;3874;4072
3512803;SP;Cosmópolis;44355;29411;29410;54629;4192;58821;74662
3512902;SP;Cosmorama;7372;3652;3562;4945;2269;7214;7289
3513009;SP;Cotia;148987;98372;102651;201023;0;201023;257882
3513108;SP;Cravinhos;28411;15887;15801;30891;797;31688;35858
3513207;SP;Cristais Paulista;6579;3877;3714;5531;2060;7591;8803
3513306;SP;Cruzália;2610;1106;1164;1502;768;2270;2021
3513405;SP;Cruzeiro;73492;37516;39554;75107;1963;77070;82895
3513504;SP;Cubatão;108309;59246;59551;118797;0;118797;132521
3513603;SP;Cunha;23090;11171;10703;12171;9703;21874;21373
3513702;SP;Descalvado;28921;15329;15724;27702;3351;31053;34097
3513801;SP;Diadema;357064;186752;199287;386039;0;386039;429550
3513850;SP;Dirce Reis;1623;875;814;1279;410;1689;1805
3513900;SP;Divinolândia;12016;5588;5621;7500;3709;11209;11027
3514007;SP;Dobrada;7007;4116;3825;7764;177;7941;9088
3514106;SP;Dois Córregos;22522;12420;12348;23453;1315;24768;27704
3514205;SP;Dolcinópolis;2152;1091;1005;1949;147;2096;2108
3514304;SP;Dourado;8606;4363;4244;7867;740;8607;8883
3514403;SP;Dracena;40500;21406;21857;39946;3317;43263;47287
3514502;SP;Duartina;12475;5970;6281;10997;1254;12251;12421
3514601;SP;Dumont;6307;4096;4047;7854;289;8143;10174
3514700;SP;Echaporã;6827;3115;3203;5032;1286;6318;6026
3514809;SP;Eldorado;14134;7479;7166;7209;7436;14645;15592
3514908;SP;Elias Fausto;13888;8169;7627;12577;3219;15796;18095
3514924;SP;Elisiário;2577;1650;1470;2858;262;3120;3742
3514957;SP;Embaúba;2478;1259;1164;2060;363;2423;2446
3515004;SP;Embu;207663;116572;123435;240007;0;240007;279264
3515103;SP;Embu-Guaçu;56916;31178;31668;61180;1666;62846;70402
3515129;SP;Emilianópolis;2893;1519;1505;2497;527;3024;3238
3515152;SP;Engenheiro Coelho;10033;8232;7487;11499;4220;15719;21712
3515186;SP;Espírito Santo do Pinhal;40480;20513;21406;37254;4665;41919;44607
3515194;SP;Espírito Santo do Turvo;3677;2146;2100;3632;614;4246;4926
3515202;SP;Estrela dOeste;8256;4133;4075;6831;1377;8208;8420
3515301;SP;Estrela do Norte;2625;1369;1292;2102;559;2661;2774
3515350;SP;Euclides da Cunha Paulista;10214;4835;4750;6111;3474;9585;9280
3515400;SP;Fartura;15010;7428;7896;12242;3082;15324;16102
3515509;SP;Fernandópolis;61647;31517;33190;62725;1982;64707;69680
3515608;SP;Fernando Prestes;5434;2726;2808;4698;836;5534;5805
3515657;SP;Fernão;1432;794;769;850;713;1563;1739
3515707;SP;Ferraz de Vasconcelos;142377;82165;86125;160751;7539;168290;198661
3515806;SP;Flora Rica;2177;880;872;1418;334;1752;1397
3515905;SP;Floreal;3223;1496;1507;2439;564;3003;2884
3516002;SP;Flórida Paulista;11106;7056;5793;10138;2711;12849;14936
3516101;SP;Florínia;3127;1383;1446;2512;317;2829;2631
3516200;SP;Franca;287737;155539;163246;313128;5657;318785;358539
3516309;SP;Francisco Morato;133738;76657;77881;154224;314;154538;179372
3516408;SP;Franco da Rocha;108122;67455;64148;121233;10370;131603;158438
3516507;SP;Gabriel Monteiro;2726;1373;1332;2254;451;2705;2776
3516606;SP;Gália;7853;3506;3505;5225;1786;7011;6419
3516705;SP;Garça;43162;20975;22149;39198;3926;43124;44429
3516804;SP;Gastão Vidigal;3586;2298;1895;3756;437;4193;4911
3516853;SP;Gavião Peixoto;4126;2286;2134;3575;845;4420;4841
3516903;SP;General Salgado;10824;5355;5319;9089;1585;10674;10855
3517000;SP;Getulina;10370;5872;4905;8339;2438;10777;11485
3517109;SP;Glicério;4428;2296;2281;3366;1211;4577;4842
3517208;SP;Guaiçara;9211;5368;5303;9698;973;10671;12416
3517307;SP;Guaimbê;5207;2697;2728;4740;685;5425;5806
3517406;SP;Guaíra;34610;18524;18888;36067;1345;37412;41283
3517505;SP;Guapiaçu;14086;9037;8848;15818;2067;17885;22087
3517604;SP;Guapiara;19726;9150;8838;7230;10758;17988;16896
3517703;SP;Guará;18916;9888;9976;19229;635;19864;21394
3517802;SP;Guaraçaí;8894;4191;4244;6655;1780;8435;8258
3517901;SP;Guaraci;8846;5084;4892;8927;1049;9976;11382
3518008;SP;Guarani dOeste;2006;963;1006;1734;235;1969;1996
3518107;SP;Guarantã;6323;3210;3190;5459;941;6400;6685
3518206;SP;Guararapes;28843;15092;15508;28326;2274;30600;33257
3518305;SP;Guararema;21904;13009;12852;22251;3610;25861;30465
3518404;SP;Guaratinguetá;104219;53948;58143;106782;5309;112091;123192
3518503;SP;Guareí;10197;8929;5639;8413;6155;14568;19244
3518602;SP;Guariba;31085;17914;17577;34753;738;35491;40857
3518701;SP;Guarujá;264812;141474;149133;290556;51;290607;324977
3518800;SP;Guarulhos;1072717;595403;626954;1222357;0;1222357;1404694
3518859;SP;Guatapará;6371;3579;3387;5116;1850;6966;7760
3518909;SP;Guzolândia;4295;2436;2318;4021;733;4754;5346
3519006;SP;Herculândia;7992;4351;4345;7921;775;8696;9649
3519055;SP;Holambra;7211;5723;5569;8182;3110;11292;15605
3519071;SP;Hortolândia;152523;97241;94984;192225;0;192225;237570
3519105;SP;Iacanga;8282;5162;4848;8723;1287;10010;12002
3519204;SP;Iacri;6783;3249;3170;5050;1369;6419;6269
3519253;SP;Iaras;3054;4197;2180;2837;3540;6377;9786
3519303;SP;Ibaté;26462;15808;14916;29505;1219;30724;35830
3519402;SP;Ibirá;9447;5407;5461;10028;840;10868;12639
3519501;SP;Ibirarema;5701;3393;3332;6212;513;6725;7926
3519600;SP;Ibitinga;46620;26217;26949;51065;2101;53166;61150
3519709;SP;Ibiúna;64384;36206;35022;24950;46278;71228;80062
3519808;SP;Icém;6772;3795;3667;6404;1058;7462;8363
3519907;SP;Iepê;7257;3780;3847;6775;852;7627;8228
3520004;SP;Igaraçu do Tietê;22614;11656;11714;23236;134;23370;24821
3520103;SP;Igarapava;25925;13844;14116;26370;1590;27960;30791
3520202;SP;Igaratá;8292;4524;4301;6991;1834;8825;9631
3520301;SP;Iguape;27427;14465;14379;24698;4146;28844;31117
3520400;SP;Ilhabela;20836;14324;13852;27982;194;28176;36194
3520426;SP;Ilha Comprida;6704;4476;4551;9027;0;9027;11552
3520442;SP;Ilha Solteira;23996;12201;12870;23523;1548;25071;26886
3520509;SP;Indaiatuba;147050;100352;101496;199835;2013;201848;260690
3520608;SP;Indiana;4932;2422;2406;4126;702;4828;4873
3520707;SP;Indiaporã;4058;1925;1981;3382;524;3906;3876
3520806;SP;Inúbia Paulista;3318;1821;1809;3177;453;3630;4045
3520905;SP;Ipaussu;12553;6941;6805;12666;1080;13746;15165
3521002;SP;Iperó;18384;15220;13081;17470;10831;28301;38771
3521101;SP;Ipeúna;4340;3109;2907;5178;838;6016;7824
3521150;SP;Ipiguá;3476;2265;2194;2690;1769;4459;5557
3521200;SP;Iporanga;4562;2170;2132;2401;1901;4302;4180
3521309;SP;Ipuã;11870;7208;6938;13560;586;14146;16794
3521408;SP;Iracemápolis;15555;10059;9988;19632;415;20047;24982
3521507;SP;Irapuã;6658;3808;3476;6489;795;7284;8101
3521606;SP;Irapuru;7457;4531;3256;5505;2282;7787;8356
3521705;SP;Itaberá;18911;9015;8846;12140;5721;17861;17405
3521804;SP;Itaí;21039;12764;11251;18858;5157;24015;27632
3521903;SP;Itajobi;14230;7350;7203;12143;2410;14553;15331
3522000;SP;Itaju;2638;1711;1552;2378;885;3263;3937
3522109;SP;Itanhaém;71995;42189;44864;86238;815;87053;104351
3522158;SP;Itaóca;3226;1687;1541;1760;1468;3228;3332
3522208;SP;Itapecerica da Serra;129685;76213;76167;151127;1253;152380;179574
3522307;SP;Itapetininga;125559;72202;72214;131051;13365;144416;167106
3522406;SP;Itapeva;82866;43242;44523;73964;13801;87765;95241
3522505;SP;Itapevi;162433;98843;102031;200874;0;200874;244131
3522604;SP;Itapira;63377;33862;34503;63405;4960;68365;75683
3522653;SP;Itapirapuã Paulista;3577;2003;1881;1895;1989;3884;4294
3522703;SP;Itápolis;37750;19872;20192;36338;3726;40064;43536
3522802;SP;Itaporanga;14354;7279;7267;11033;3513;14546;15197
3522901;SP;Itapuí;10371;6155;6026;11638;543;12181;14297
3523008;SP;Itapura;3838;2257;2103;3484;876;4360;4994
3523107;SP;Itaquaquecetuba;272942;158597;163257;321854;0;321854;379082
3523206;SP;Itararé;46554;23524;24415;44275;3664;47939;50778
3523305;SP;Itariri;13613;7794;7677;9879;5592;15471;17754
3523404;SP;Itatiba;81197;50115;51335;85640;15810;101450;124254
3523503;SP;Itatinga;15446;9230;8822;16420;1632;18052;21139
3523602;SP;Itirapina;12836;9158;6370;14004;1524;15528;18610
3523701;SP;Itirapuã;5412;3013;2901;4929;985;5914;6587
3523800;SP;Itobi;7466;3907;3638;6795;750;7545;7862
3523909;SP;Itu;135366;76243;77957;144336;9864;154200;177150
3524006;SP;Itupeva;26166;22773;22052;38941;5884;44825;64330
3524105;SP;Ituverava;36268;18875;19824;36431;2268;38699;42259
3524204;SP;Jaborandi;6424;3338;3254;6166;426;6592;6963
3524303;SP;Jaboticabal;67408;34797;36870;69532;2135;71667;78029
3524402;SP;Jacareí;191291;103135;108173;208389;2919;211308;237119
3524501;SP;Jaci;4117;2892;2765;4871;786;5657;7322
3524600;SP;Jacupiranga;17041;8771;8425;9357;7839;17196;17911
3524709;SP;Jaguariúna;29597;22023;22308;43047;1284;44331;59921
3524808;SP;Jales;46186;22986;24026;44239;2773;47012;49291
3524907;SP;Jambeiro;3992;2768;2582;2561;2789;5350;6828
3525003;SP;Jandira;91807;53105;55331;108436;0;108436;127734
3525102;SP;Jardinópolis;30729;18975;18750;36201;1524;37725;45544
3525201;SP;Jarinu;17041;11997;11830;18420;5407;23827;31173
3525300;SP;Jaú;112104;64222;66846;126971;4097;131068;153463
3525409;SP;Jeriquara;3280;1627;1541;2614;554;3168;3143
3525508;SP;Joanópolis;10409;5933;5838;11771;0;11771;13453
3525607;SP;João Ramalho;3842;2093;2045;3534;604;4138;4577
3525706;SP;José Bonifácio;28714;16365;16409;29695;3079;32774;37707
3525805;SP;Júlio Mesquita;4166;2179;2251;4214;216;4430;4824
3525854;SP;Jumirim;2196;1445;1356;1629;1172;2801;3467
3525904;SP;Jundiaí;323397;180102;190149;354301;15950;370251;426935
3526001;SP;Junqueirópolis;17005;9921;8805;15399;3327;18726;20978
3526100;SP;Juquiá;20516;9753;9516;12144;7125;19269;18627
3526209;SP;Juquitiba;26459;14533;14199;22240;6492;28732;31844
3526308;SP;Lagoinha;4957;2479;2361;3137;1703;4840;4882
3526407;SP;Laranjal Paulista;22145;12461;12785;22602;2644;25246;29047
3526506;SP;Lavínia;5131;6188;2594;4287;4495;8782;12581
3526605;SP;Lavrinhas;6008;3317;3269;6045;541;6586;7361
3526704;SP;Leme;80757;46054;45750;89902;1902;91804;105273
3526803;SP;Lençóis Paulista;55042;30498;30956;60077;1377;61454;69533
3526902;SP;Limeira;249046;135637;140373;267775;8235;276010;310783
3527009;SP;Lindóia;5331;3327;3381;6708;0;6708;8201
3527108;SP;Lins;65952;34718;36775;70658;835;71493;78978
3527207;SP;Lorena;77990;39869;42684;80182;2371;82553;89532
3527256;SP;Lourdes;2007;1104;1019;1744;379;2123;2311
3527306;SP;Louveira;23903;18814;18339;35743;1410;37153;51007
3527405;SP;Lucélia;18316;10560;9325;17222;2663;19885;22022
3527504;SP;Lucianópolis;2154;1123;1132;1789;466;2255;2412
3527603;SP;Luís Antônio;7160;5832;5454;10901;385;11286;15628
3527702;SP;Luiziânia;4274;2612;2418;4611;419;5030;5918
3527801;SP;Lupércio;4230;2121;2232;3865;488;4353;4608
3527900;SP;Lutécia;2897;1346;1357;2150;553;2703;2623
3528007;SP;Macatuba;15752;8147;8099;15763;483;16246;17263
3528106;SP;Macaubal;7385;3880;3783;6773;890;7663;8174
3528205;SP;Macedônia;3761;1837;1827;2777;887;3664;3686
3528304;SP;Magda;3421;1651;1549;2655;545;3200;3086
3528403;SP;Mairinque;39975;21524;21701;34702;8523;43225;47723
3528502;SP;Mairiporã;60111;40937;39983;70659;10261;80920;103645
3528601;SP;Manduri;8271;4523;4476;7785;1214;8999;9972
3528700;SP;Marabá Paulista;3699;3048;1764;2142;2670;4812;6039
3528809;SP;Maracaí;13004;6670;6674;12098;1246;13344;14069
3528858;SP;Marapoama;2238;1345;1288;2203;430;2633;3097
3528908;SP;Mariápolis;3854;2021;1895;3137;779;3916;4098
3529005;SP;Marília;197342;104694;111990;207737;8947;216684;242249
3529104;SP;Marinópolis;2195;1063;1050;1671;442;2113;2101
3529203;SP;Martinópolis;22346;12618;11642;20379;3881;24260;26791
3529302;SP;Matão;71753;38038;38761;75386;1413;76799;84069
3529401;SP;Mauá;363392;204180;213101;417281;0;417281;481725
3529500;SP;Mendonça;3759;2357;2283;3793;847;4640;5638
3529609;SP;Meridiano;4025;1890;1961;2676;1175;3851;3813
3529658;SP;Mesópolis;1930;957;929;1468;418;1886;1903
3529708;SP;Miguelópolis;19019;10202;10240;19269;1173;20442;22480
3529807;SP;Mineiros do Tietê;11410;5993;6049;11504;538;12042;13023
3529906;SP;Miracatu;22383;10414;10181;10586;10009;20595;19511
3530003;SP;Mira Estrela;2596;1406;1421;1881;946;2827;3125
3530102;SP;Mirandópolis;25936;15052;12423;24455;3020;27475;29844
3530201;SP;Mirante do Paranapanema;16213;8665;8399;10047;7017;17064;18415
3530300;SP;Mirassol;48327;26419;27390;52458;1351;53809;60768
3530409;SP;Mirassolândia;3741;2193;2102;3492;803;4295;4966
3530508;SP;Mococa;65574;33067;33236;61159;5144;66303;69072
3530607;SP;Mogi das Cruzes;330241;188658;198583;357294;29947;387241;455587
3530706;SP;Mogi Guaçu;124228;68115;69171;130336;6950;137286;154146
3530805;SP;Mogi Mirim;81467;42470;43774;80670;5574;86244;94098
3530904;SP;Mombuca;3107;1663;1603;2685;581;3266;3523
3531001;SP;Monções;2055;1101;1033;1838;296;2134;2274
3531100;SP;Mongaguá;35098;23109;23201;46108;202;46310;58567
3531209;SP;Monte Alegre do Sul;6321;3578;3570;4087;3061;7148;8181
3531308;SP;Monte Alto;43613;22980;23667;44548;2099;46647;51039
3531407;SP;Monte Aprazível;18413;10815;10933;19805;1943;21748;25651
3531506;SP;Monte Azul Paulista;19553;9491;9440;17713;1218;18931;18928
3531605;SP;Monte Castelo;4089;2011;2052;3211;852;4063;4166
3531704;SP;Monteiro Lobato;3615;2149;1974;1790;2333;4123;4739
3531803;SP;Monte Mor;37340;24496;24475;45996;2975;48971;61707
3531902;SP;Morro Agudo;25428;14885;14242;27918;1209;29127;33598
3532009;SP;Morungaba;9911;5897;5878;10057;1718;11775;13936
3532058;SP;Motuca;3871;2162;2128;3108;1182;4290;4831
3532108;SP;Murutinga do Sul;3971;2097;2089;2573;1613;4186;4525
3532157;SP;Nantes;2269;1357;1350;2431;276;2707;3215
3532207;SP;Narandiba;3743;2172;2117;3105;1184;4289;4950
3532306;SP;Natividade da Serra;6952;3487;3194;2788;3893;6681;6624
3532405;SP;Nazaré Paulista;14410;8453;7960;13910;2503;16413;18866
3532504;SP;Neves Paulista;8907;4365;4412;7921;856;8777;8917
3532603;SP;Nhandeara;10194;5281;5444;8688;2037;10725;11575
3532702;SP;Nipoã;3267;2262;2012;3797;477;4274;5381
3532801;SP;Nova Aliança;4768;2922;2969;4881;1010;5891;7161
3532827;SP;Nova Campina;7295;4345;4170;5762;2753;8515;9962
3532843;SP;Nova Canaã Paulista;2483;1076;1038;880;1234;2114;1824
3532868;SP;Nova Castilho;991;557;570;746;381;1127;1290
3532900;SP;Nova Europa;7307;4648;4653;8629;672;9301;11519
3533007;SP;Nova Granada;17020;9660;9518;17773;1405;19178;21871
3533106;SP;Nova Guataporanga;2087;1104;1074;1893;285;2178;2333
3533205;SP;Nova Independência;2063;1526;1546;2448;624;3072;4135
3533254;SP;Novais;3225;2479;2116;4184;411;4595;6057
3533304;SP;Nova Luzitânia;2749;1820;1621;3087;354;3441;4217
3533403;SP;Nova Odessa;42071;25365;25913;50440;838;51278;61716
3533502;SP;Novo Horizonte;32432;18270;18342;34067;2545;36612;41765
3533601;SP;Nuporanga;6309;3410;3407;6185;632;6817;7522
3533700;SP;Ocauçu;4164;2137;2026;3324;839;4163;4294
3533809;SP;Óleo;2994;1344;1329;1763;910;2673;2447
3533908;SP;Olímpia;46013;24562;25230;47092;2700;49792;55477
3534005;SP;Onda Verde;3413;1993;1891;3043;841;3884;4462
3534104;SP;Oriente;5884;2985;3112;5695;402;6097;6569
3534203;SP;Orindiúva;4161;2900;2778;5226;452;5678;7318
3534302;SP;Orlândia;36004;19499;20282;38756;1025;39781;44682
3534401;SP;Osasco;652593;320268;346201;666469;0;666469;701428
3534500;SP;Oscar Bressane;2552;1218;1321;2101;438;2539;2603
3534609;SP;Osvaldo Cruz;29648;15554;15363;27782;3135;30917;33118
3534708;SP;Ourinhos;93868;49972;53054;100368;2658;103026;115139
3534757;SP;Ouroeste;6290;4191;4215;7547;859;8406;10712
3534807;SP;Ouro Verde;7148;3864;3930;7170;624;7794;8676
3534906;SP;Pacaembu;12518;7450;5484;9745;3189;12934;14326
3535002;SP;Palestina;9100;5596;5456;9189;1863;11052;13285
3535101;SP;Palmares Paulista;8437;5863;5075;10623;315;10938;13691
3535200;SP;Palmeira dOeste;10322;4805;4779;7268;2316;9584;9173
3535309;SP;Palmital;20701;10393;10864;19498;1759;21257;22322
3535408;SP;Panorama;13649;7319;7284;14168;435;14603;15944
3535507;SP;Paraguaçu Paulista;39618;21264;21017;38319;3962;42281;46180
3535606;SP;Paraibuna;17009;8823;8561;5240;12144;17384;18302
3535705;SP;Paraíso;5429;3019;2888;5194;713;5907;6536
3535804;SP;Paranapanema;15510;9061;8749;14481;3329;17810;20588
3535903;SP;Paranapuã;3632;1950;1865;3394;421;3815;4112
3536000;SP;Parapuã;11104;5535;5309;8896;1948;10844;10934
3536109;SP;Pardinho;4732;2844;2738;4389;1193;5582;6579
3536208;SP;Pariquera-Açu;17649;9143;9310;12661;5792;18453;19797
3536257;SP;Parisi;1948;1044;988;1643;389;2032;2177
3536307;SP;Patrocínio Paulista;11416;6596;6406;10501;2501;13002;14941
3536406;SP;Paulicéia;5302;3292;3050;5271;1071;6342;7540
3536505;SP;Paulínia;51326;40677;41473;82074;76;82150;114508
3536570;SP;Paulistânia;1779;919;859;1211;567;1778;1835
3536604;SP;Paulo de Faria;8472;4299;4290;7750;839;8589;8973
3536703;SP;Pederneiras;36614;20879;20651;38613;2917;41530;47523
3536802;SP;Pedra Bela;5609;3030;2750;1440;4340;5780;6127
3536901;SP;Pedranópolis;2734;1309;1252;1593;968;2561;2468
3537008;SP;Pedregulho;14994;7982;7717;11585;4114;15699;16876
3537107;SP;Pedreira;35219;20592;20957;41197;352;41549;48992
3537156;SP;Pedrinhas Paulista;2861;1460;1476;2479;457;2936;3109
3537206;SP;Pedro de Toledo;9187;5162;5051;7042;3171;10213;11507
3537305;SP;Penápolis;54635;28579;29950;55901;2628;58529;64098
3537404;SP;Pereira Barreto;25028;12270;12689;23235;1724;24959;25685
3537503;SP;Pereiras;6226;3793;3675;4981;2487;7468;8875
3537602;SP;Peruíbe;51451;29153;30640;59125;668;59793;69697
3537701;SP;Piacatu;4625;2662;2625;4663;624;5287;6093
3537800;SP;Piedade;50131;26602;25612;23782;28432;52214;55731
3537909;SP;Pilar do Sul;23948;13415;12996;20590;5821;26411;29612
3538006;SP;Pindamonhangaba;126026;72310;74724;141737;5297;147034;171885
3538105;SP;Pindorama;13109;7695;7348;14239;804;15043;17378
3538204;SP;Pinhalzinho;10986;6592;6512;6455;6649;13104;15564
3538303;SP;Piquerobi;3478;1755;1786;2673;868;3541;3706
3538501;SP;Piquete;15200;6817;7290;13212;895;14107;13495
3538600;SP;Piracaia;23347;12532;12607;25139;0;25139;27617
3538709;SP;Piracicaba;329158;178538;186334;355136;9736;364872;410275
3538808;SP;Piraju;27897;13833;14656;25617;2872;28489;29930
3538907;SP;Pirajuí;20095;12584;10140;18511;4213;22724;25939
3539004;SP;Pirangi;10038;5393;5230;9528;1095;10623;11524
3539103;SP;Pirapora do Bom Jesus;12395;7809;7918;15727;0;15727;19453
3539202;SP;Pirapozinho;22104;12087;12631;23477;1241;24718;27974
3539301;SP;Pirassununga;64864;34311;35827;64264;5874;70138;77330
3539400;SP;Piratininga;10584;5983;6089;10347;1725;12072;13890
3539509;SP;Pitangueiras;31156;18008;17306;33955;1359;35314;40430
3539608;SP;Planalto;3670;2320;2152;3775;697;4472;5370
3539707;SP;Platina;2867;1660;1532;2513;679;3192;3606
3539806;SP;Poá;95801;51330;54703;104355;1678;106033;119221
3539905;SP;Poloni;4774;2671;2724;4802;593;5395;6166
3540002;SP;Pompéia;18171;9792;10171;18573;1390;19963;22326
3540101;SP;Pongaí;3693;1793;1686;2923;556;3479;3385
3540200;SP;Pontal;29681;21175;19070;39493;752;40245;51717
3540259;SP;Pontalinda;3539;2160;1914;3381;693;4074;4719
3540309;SP;Pontes Gestal;2539;1258;1265;2128;395;2523;2576
3540408;SP;Populina;4450;2139;2084;3412;811;4223;4136
3540507;SP;Porangaba;6652;4295;4038;4028;4305;8333;10205
3540606;SP;Porto Feliz;45514;24545;24369;41111;7803;48914;53698
3540705;SP;Porto Ferreira;47437;25506;25901;50485;922;51407;56848
3540754;SP;Potim;13605;10986;8427;14710;4703;19413;25603
3540804;SP;Potirendaba;13656;7857;7596;13886;1567;15453;17668
3540853;SP;Pracinha;1431;2085;778;1369;1494;2863;4327
3540903;SP;Pradópolis;12912;8901;8503;16127;1277;17404;22239
3541000;SP;Praia Grande;193582;125280;135489;260769;0;260769;336454
3541059;SP;Pratânia;3950;2379;2220;3485;1114;4599;5371
3541109;SP;Presidente Alves;4317;2038;2085;3431;692;4123;4067
3541208;SP;Presidente Bernardes;14662;6673;6871;10473;3071;13544;12943
3541307;SP;Presidente Epitácio;39298;20219;21105;38551;2773;41324;44572
3541406;SP;Presidente Prudente;189186;99913;107712;203370;4255;207625;231953
3541505;SP;Presidente Venceslau;37347;18918;18997;36275;1640;37915;39648
3541604;SP;Promissão;31105;17760;17928;30084;5604;35688;41211
3541653;SP;Quadra;2651;1707;1529;828;2408;3236;3902
3541703;SP;Quatá;11655;6412;6416;12040;788;12828;14309
3541802;SP;Queiroz;2171;1424;1384;2385;423;2808;3513
3541901;SP;Queluz;9112;5767;5558;9282;2043;11325;13788
3542008;SP;Quintana;5443;2971;3037;5498;510;6008;6736
3542107;SP;Rafard;8360;4267;4357;7603;1021;8624;9126
3542206;SP;Rancharia;28772;14130;14643;25801;2972;28773;29743
3542305;SP;Redenção da Serra;4047;2016;1863;2214;1665;3879;3827
3542404;SP;Regente Feijó;16998;9196;9300;17048;1448;18496;20523
3542503;SP;Reginópolis;4742;4683;2642;4362;2963;7325;10047
3542602;SP;Registro;53752;26667;27612;48187;6092;54279;56463
3542701;SP;Restinga;5584;3296;3291;5179;1408;6587;7762
3542800;SP;Ribeira;3507;1742;1616;1236;2122;3358;3320
3542909;SP;Ribeirão Bonito;11246;6100;6029;11214;915;12129;13376
3543006;SP;Ribeirão Branco;21231;9398;8874;9296;8976;18272;15984
3543105;SP;Ribeirão Corrente;3881;2218;2055;3397;876;4273;4786
3543204;SP;Ribeirão do Sul;4497;2244;2220;3309;1155;4464;4537
3543238;SP;Ribeirão dos Índios;2222;1088;1099;1850;337;2187;2222
3543253;SP;Ribeirão Grande;7390;3793;3626;2342;5077;7419;7686
3543303;SP;Ribeirão Pires;104508;55275;57768;113043;0;113043;125238
3543402;SP;Ribeirão Preto;504923;290286;314828;603401;1713;605114;720116
3543501;SP;Riversul;7192;3046;3119;4494;1671;6165;5364
3543600;SP;Rifaina;3325;1725;1711;3009;427;3436;3651
3543709;SP;Rincão;10330;5244;5170;8460;1954;10414;10824
3543808;SP;Rinópolis;10255;5051;4884;8636;1299;9935;9940
3543907;SP;Rio Claro;168218;90708;95591;181766;4533;186299;209548
3544004;SP;Rio das Pedras;23494;14922;14586;28569;939;29508;36233
3544103;SP;Rio Grande da Serra;37091;21877;22207;44084;0;44084;52009
3544202;SP;Riolândia;8560;6021;4553;8365;2209;10574;12856
3544251;SP;Rosana;24229;9780;9911;15858;3833;19691;15929
3544301;SP;Roseira;8577;4846;4760;9123;483;9606;10888
3544400;SP;Rubiácea;2337;1392;1337;1563;1166;2729;3195
3544509;SP;Rubinéia;2615;1415;1447;2355;507;2862;3191
3544608;SP;Sabino;4951;2629;2597;4584;642;5226;5638
3544707;SP;Sagres;2439;1191;1204;1819;576;2395;2427
3544806;SP;Sales;4563;2786;2664;4903;547;5450;6481
3544905;SP;Sales Oliveira;9325;5241;5327;9569;999;10568;12103
3545001;SP;Salesópolis;14357;7908;7731;9956;5683;15639;17363
3545100;SP;Salmourão;4401;2477;2341;4321;497;4818;5372
3545159;SP;Saltinho;5799;3519;3540;5891;1168;7059;8498
3545209;SP;Salto;93159;52146;53423;104827;742;105569;120779
3545308;SP;Salto de Pirapora;35072;19959;20182;31463;8678;40141;46285
3545407;SP;Salto Grande;8444;4354;4433;7934;853;8787;9396
3545506;SP;Sandovalina;3089;1884;1815;2581;1118;3699;4405
3545605;SP;Santa Adélia;13449;7164;7169;13560;773;14333;15639
3545704;SP;Santa Albertina;5586;2905;2818;4891;832;5723;6036
3545803;SP;Santa Bárbara dOeste;170078;89311;90837;178728;1420;180148;195278
3546009;SP;Santa Branca;13010;6878;6892;12145;1625;13770;14925
3546108;SP;Santa Clara dOeste;2123;1073;1011;1571;513;2084;2111
3546207;SP;Santa Cruz da Conceição;3531;1979;2019;2708;1290;3998;4584
3546256;SP;Santa Cruz da Esperança;1796;966;987;1323;630;1953;2166
3546306;SP;Santa Cruz das Palmeiras;25556;15245;14729;29042;932;29974;35102
3546405;SP;Santa Cruz do Rio Pardo;40919;21513;22416;40161;3768;43929;48207
3546504;SP;Santa Ernestina;5741;2852;2716;5145;423;5568;5577
3546603;SP;Santa Fé do Sul;26512;14073;15162;28084;1151;29235;32796
3546702;SP;Santa Gertrudes;15906;10957;10687;21414;230;21644;27850
3546801;SP;Santa Isabel;43740;25260;25204;39596;10868;50464;58529
3546900;SP;Santa Lúcia;7853;4129;4117;7752;494;8246;8889
3547007;SP;Santa Maria da Serra;4673;2750;2668;4777;641;5418;6298
3547106;SP;Santa Mercedes;2803;1423;1408;2458;373;2831;2947
3547205;SP;Santana da Ponte Pensa;1894;841;800;1097;544;1641;1448
3547304;SP;Santana de Parnaíba;74828;53652;55223;108875;0;108875;145073
3547403;SP;Santa Rita dOeste;2695;1264;1279;1773;770;2543;2476
3547502;SP;Santa Rita do Passa Quatro;26138;12785;13635;23643;2777;26420;27641
3547601;SP;Santa Rosa de Viterbo;21435;11780;12091;22756;1115;23871;26960
3547650;SP;Santa Salete;1379;743;704;819;628;1447;1558
3547700;SP;Santo Anastácio;20749;9994;10504;19100;1398;20498;20855
3547809;SP;Santo André;649331;323208;350706;673914;0;673914;723889
3547908;SP;Santo Antônio da Alegria;5764;3260;3044;4669;1635;6304;7024
3548005;SP;Santo Antônio de Posse;18124;10398;10237;18813;1822;20635;23742
3548054;SP;Santo Antônio do Aracanguá;6929;3881;3746;5977;1650;7627;8541
3548104;SP;Santo Antônio do Jardim;6154;3045;2898;3532;2411;5943;5926
3548203;SP;Santo Antônio do Pinhal;6328;3285;3231;3868;2648;6516;6843
3548302;SP;Santo Expedito;2526;1407;1399;2484;322;2806;3159
3548401;SP;Santópolis do Aguapeí;3816;2170;2111;4134;147;4281;4856
3548500;SP;Santos;417983;192056;227701;419443;314;419757;433991
3548609;SP;São Bento do Sapucaí;10355;5268;5194;5032;5430;10462;10907
3548708;SP;São Bernardo do Campo;703177;369489;395714;752414;12789;765203;849874
3548807;SP;São Caetano do Sul;140159;69024;80547;149571;0;149571;162763
3548906;SP;São Carlos;192998;108875;113061;213070;8866;221936;256915
3549003;SP;São Francisco;2863;1400;1393;2167;626;2793;2813
3549102;SP;São João da Boa Vista;77387;40558;43103;80324;3337;83661;92315
3549201;SP;São João das Duas Pontes;2660;1290;1276;1961;605;2566;2555
3549250;SP;São João de Iracema;1671;898;882;1452;328;1780;1942
3549300;SP;São João do Pau dAlho;2180;1057;1046;1705;398;2103;2095
3549409;SP;São Joaquim da Barra;41587;22801;23723;45690;834;46524;52737
3549508;SP;São José da Bela Vista;8075;4312;4095;7486;921;8407;8991
3549607;SP;São José do Barreiro;4143;2061;2036;2872;1225;4097;4141
3549706;SP;São José do Rio Pardo;50077;25550;26360;45974;5936;51910;55298
3549805;SP;São José do Rio Preto;358523;196114;212321;383558;24877;408435;469173
3549904;SP;São José dos Campos;539313;307394;320150;615610;11934;627544;737310
3549953;SP;São Lourenço da Serra;12199;7100;6885;12725;1260;13985;16127
3550001;SP;São Luíz do Paraitinga;10429;5321;5083;6185;4219;10404;10693
3550100;SP;São Manuel;36545;18792;19598;37461;929;38390;41287
3550209;SP;São Miguel Arcanjo;30798;15996;15456;21504;9948;31452;33071
3550308;SP;São Paulo;10434252;5323385;5920984;11125243;119126;11244369;12396372
3550407;SP;São Pedro;27897;15439;16249;26635;5053;31688;36298
3550506;SP;São Pedro do Turvo;6888;3676;3532;5158;2050;7208;7724
3550605;SP;São Roque;66637;38793;40080;71536;7337;78873;93076
3550704;SP;São Sebastião;58038;36827;37006;73000;833;73833;91637
3550803;SP;São Sebastião da Grama;12454;6166;5934;7970;4130;12100;12137
3550902;SP;São Simão;13675;7062;7288;12930;1420;14350;15446
3551009;SP;São Vicente;303551;159571;172853;331792;632;332424;370839
3551108;SP;Sarapuí;7805;4594;4433;6646;2381;9027;10493
3551207;SP;Sarutaiá;3739;1819;1803;2957;665;3622;3623
3551306;SP;Sebastianópolis do Sul;2546;1525;1506;2347;684;3031;3595
3551405;SP;Serra Azul;7446;6872;4387;8021;3238;11259;15292
3551504;SP;Serrana;32603;19492;19399;38479;412;38891;46166
3551603;SP;Serra Negra;23851;12860;13502;22865;3497;26362;29669
3551702;SP;Sertãozinho;94664;54714;55380;108792;1302;110094;128432
3551801;SP;Sete Barras;13714;6682;6324;7035;5971;13006;12731
3551900;SP;Severínia;13605;8046;7458;14777;727;15504;17820
3552007;SP;Silveiras;5378;2936;2856;2879;2913;5792;6375
3552106;SP;Socorro;32704;18211;18484;24947;11748;36695;41690
3552205;SP;Sorocaba;493468;286798;299513;580340;5971;586311;695328
3552304;SP;Sud Mennucci;7365;3745;3695;6394;1046;7440;7738
3552403;SP;Sumaré;196723;119984;121453;238599;2838;241437;289875
3552502;SP;Suzano;228690;128797;133771;253328;9240;262568;303397
3552551;SP;Suzanápolis;2790;1748;1635;2258;1125;3383;4063
3552601;SP;Tabapuã;10493;5744;5622;10522;844;11366;12561
3552700;SP;Tabatinga;12990;7565;7121;12578;2108;14686;16787
3552809;SP;Taboão da Serra;197644;116920;127799;244719;0;244719;297528
3552908;SP;Taciba;5221;2862;2852;4852;862;5714;6371
3553005;SP;Taguaí;7468;5382;5443;7754;3071;10825;14415
3553104;SP;Taiaçu;5619;2972;2922;5339;555;5894;6346
3553203;SP;Taiúva;5506;2696;2751;4967;480;5447;5562
3553302;SP;Tambaú;22258;11179;11231;19912;2498;22410;23255
3553401;SP;Tanabi;22587;12042;12013;21735;2320;24055;26231
3553500;SP;Tapiraí;8570;4037;3978;5728;2287;8015;7725
3553609;SP;Tapiratiba;12942;6336;6407;10497;2246;12743;12940
3553658;SP;Taquaral;2722;1373;1353;2613;113;2726;2815
3553708;SP;Taquaritinga;52065;26659;27326;51165;2820;53985;57547
3553807;SP;Taquarituba;21982;11091;11203;19582;2712;22294;23292
3553856;SP;Taquarivaí;4473;2577;2572;2809;2340;5149;5968
3553906;SP;Tarabai;5786;3294;3311;6106;499;6605;7609
3553955;SP;Tarumã;10743;6583;6300;12124;759;12883;15361
3554003;SP;Tatuí;93430;53358;54617;102456;5519;107975;124134
3554102;SP;Taubaté;244165;136785;141939;272712;6012;278724;320820
3554201;SP;Tejupá;5336;2467;2342;3120;1689;4809;4452
3554300;SP;Teodoro Sampaio;20003;10667;10722;17368;4021;21389;23395
3554409;SP;Terra Roxa;7752;4306;4199;8107;398;8505;9502
3554508;SP;Tietê;31710;18259;18568;33470;3357;36827;42946
3554607;SP;Timburi;2731;1364;1282;1924;722;2646;2647
3554656;SP;Torre de Pedra;2144;1192;1065;1472;785;2257;2432
3554706;SP;Torrinha;8837;4707;4623;7939;1391;9330;10100
3554755;SP;Trabiju;1380;770;774;1418;126;1544;1752
3554805;SP;Tremembé;34823;21670;19315;36929;4056;40985;48228
3554904;SP;Três Fronteiras;5159;2716;2712;4599;829;5428;5856
3554953;SP;Tuiuti;4956;3025;2910;2973;2962;5935;7058
3555000;SP;Tupã;63333;30740;32752;60946;2546;63492;65615
3555109;SP;Tupi Paulista;13286;7574;6688;11203;3059;14262;15670
3555208;SP;Turiúba;1895;997;930;1577;350;1927;2024
3555307;SP;Turmalina;2366;982;996;1407;571;1978;1667
3555356;SP;Ubarana;4220;2710;2576;4841;445;5286;6488
3555406;SP;Ubatuba;66861;39223;39647;76958;1912;78870;92819
3555505;SP;Ubirajara;4156;2286;2143;3229;1200;4429;4828
3555604;SP;Uchoa;9035;4709;4766;8798;677;9475;10191
3555703;SP;União Paulista;1354;829;770;1224;375;1599;1886
3555802;SP;Urânia;8825;4395;4441;7436;1400;8836;9125
3555901;SP;Uru;1404;641;610;1081;170;1251;1142
3556008;SP;Urupês;11833;6323;6397;11320;1400;12720;13965
3556107;SP;Valentim Gentil;8605;5542;5489;10074;957;11031;13732
3556206;SP;Valinhos;82973;52757;54211;101820;5148;106968;133169
3556305;SP;Valparaíso;18574;12434;10183;21512;1105;22617;27154
3556354;SP;Vargem;6975;4519;4282;4421;4380;8801;10842
3556404;SP;Vargem Grande do Sul;36302;19484;19782;37274;1992;39266;43368
3556453;SP;Vargem Grande Paulista;32683;21310;21636;42946;0;42946;54315
3556503;SP;Várzea Paulista;92800;53459;53687;107146;0;107146;124269
3556602;SP;Vera Cruz;11085;5298;5471;9363;1406;10769;10804
3556701;SP;Vinhedo;47215;31520;32165;61688;1997;63685;81516
3556800;SP;Viradouro;15962;8720;8587;16801;506;17307;19133
3556909;SP;Vista Alegre do Alto;4754;3545;3344;6355;534;6889;9163
3556958;SP;Vitória Brasil;1675;891;846;1435;302;1737;1852
3557006;SP;Votorantim;95925;54047;54825;104699;4173;108872;124468
3557105;SP;Votuporanga;75641;41336;43392;82355;2373;84728;96106
3557154;SP;Zacarias;1947;1174;1160;1836;498;2334;2784
3557204;SP;Chavantes;12194;6028;6086;11139;975;12114;12418
3557303;SP;Estiva Gerbi;8856;5074;4970;8011;2033;10044;11507
4100103;PR;Abatiá;8259;3911;3842;5721;2032;7753;7360
4100202;PR;Adrianópolis;7007;3296;3078;2060;4314;6374;5797
4100301;PR;Agudos do Sul;7221;4306;3964;2822;5448;8270;9567
4100400;PR;Almirante Tamandaré;88277;51181;52064;98954;4291;103245;121420
4100459;PR;Altamira do Paraná;6999;2202;2104;2135;2171;4306;1429
4100509;PR;Altônia;19230;10157;10359;15094;5422;20516;22293
4100608;PR;Alto Paraná;12717;6841;6821;11219;2443;13662;14945
4100707;PR;Alto Piquiri;10761;5128;5051;8375;1804;10179;9722
4100806;PR;Alvorada do Sul;9253;5212;5086;7348;2950;10298;11598
4100905;PR;Amaporã;4655;2756;2688;4332;1112;5444;6405
4101002;PR;Ampére;15623;8586;8722;13257;4051;17308;19466
4101051;PR;Anahy;3011;1435;1430;2099;766;2865;2774
4101101;PR;Andirá;21663;10043;10572;19356;1259;20615;19823
4101150;PR;Ângulo;2840;1457;1404;2255;606;2861;2931
4101200;PR;Antonina;19174;9349;9542;16063;2828;18891;18919
4101309;PR;Antônio Olinto;7407;3857;3494;687;6664;7351;7421
4101408;PR;Apucarana;107827;58630;62254;114104;6780;120884;137438
4101507;PR;Arapongas;85428;51045;53116;101862;2299;104161;126545
4101606;PR;Arapoti;23884;12949;12907;21779;4077;25856;28480
4101655;PR;Arapuã;4172;1760;1794;1331;2223;3554;2951
4101705;PR;Araruna;13081;6823;6601;10480;2944;13424;14029
4101804;PR;Araucária;94258;59668;59539;110293;8914;119207;148522
4101853;PR;Ariranha do Ivaí;2883;1229;1224;904;1549;2453;2026
4101903;PR;Assaí;18045;8019;8349;13601;2767;16368;14792
4102000;PR;Assis Chateaubriand;33317;16179;16849;29018;4010;33028;33306
4102109;PR;Astorga;23637;12147;12557;22563;2141;24704;26304
4102208;PR;Atalaia;4015;1970;1943;3347;566;3913;3871
4102307;PR;Balsa Nova;10153;5718;5576;6871;4423;11294;13238
4102406;PR;Bandeirantes;33732;15550;16632;28382;3800;32182;31061
4102505;PR;Barbosa Ferraz;14110;6366;6287;9584;3069;12653;11287
4102604;PR;Barracão;9271;4799;4938;7015;2722;9737;10347
4102703;PR;Barra do Jacaré;2723;1385;1342;1851;876;2727;2781
4102752;PR;Bela Vista da Caroba;4503;2016;1923;1038;2901;3939;3404
4102802;PR;Bela Vista do Paraíso;15031;7318;7762;14198;882;15080;15400
4102901;PR;Bituruna;15733;8152;7731;9902;5981;15883;16411
4103008;PR;Boa Esperança;5162;2280;2288;2640;1928;4568;3991
4103024;PR;Boa Esperança do Iguaçu;3107;1403;1365;957;1811;2768;2437
4103040;PR;Boa Ventura de São Roque;6780;3345;3204;1544;5005;6549;6343
4103057;PR;Boa Vista da Aparecida;8423;3994;3917;4900;3011;7911;7524
4103107;PR;Bocaiúva do Sul;9050;5570;5435;5136;5869;11005;13308
4103156;PR;Bom Jesus do Sul;4154;1969;1827;933;2863;3796;3472
4103206;PR;Bom Sucesso;6173;3228;3340;5337;1231;6568;7103
4103222;PR;Bom Sucesso do Sul;3392;1639;1657;1581;1715;3296;3244
4103305;PR;Borrazópolis;9453;3937;3940;5809;2068;7877;6290
4103354;PR;Braganey;6191;2938;2797;3417;2318;5735;5338
4103370;PR;Brasilândia do Sul;3889;1602;1607;2178;1031;3209;2521
4103404;PR;Cafeara;2485;1376;1319;2195;500;2695;2973
4103453;PR;Cafelândia;11143;7287;7264;12316;2235;14551;18783
4103479;PR;Cafezal do Sul;4648;2167;2118;3323;962;4285;3975
4103503;PR;Califórnia;7678;4051;4018;6028;2041;8069;8641
4103602;PR;Cambará;22740;11640;12231;22348;1523;23871;25569
4103701;PR;Cambé;88186;47302;49433;92956;3779;96735;108126
4103800;PR;Cambira;6688;3674;3562;5475;1761;7236;7967
4103909;PR;Campina da Lagoa;17018;7650;7743;12556;2837;15393;13888
4103958;PR;Campina do Simão;4365;2134;1942;1388;2688;4076;3831
4104006;PR;Campina Grande do Sul;34566;19220;19536;31937;6819;38756;44072
4104055;PR;Campo Bonito;5128;2215;2192;2580;1827;4407;3694
4104105;PR;Campo do Tenente;6335;3677;3448;4194;2931;7125;8118
4104204;PR;Campo Largo;92782;55735;56751;94253;18233;112486;135678
4104253;PR;Campo Magro;20409;12504;12332;19548;5288;24836;30151
4104303;PR;Campo Mourão;80476;42085;45202;82757;4530;87287;96102
4104402;PR;Cândido de Abreu;18795;8551;8111;4759;11903;16662;14606
4104428;PR;Candói;14185;7551;7431;7011;7971;14982;16126
4104451;PR;Cantagalo;12810;6562;6390;8509;4443;12952;13340
4104501;PR;Capanema;18239;9152;9360;11136;7376;18512;19172
4104600;PR;Capitão Leônidas Marques;14377;7457;7479;11456;3480;14936;15887
4104659;PR;Carambeí;14860;9703;9468;13926;5245;19171;24225
4104709;PR;Carlópolis;13305;6932;6774;9354;4352;13706;14391
4104808;PR;Cascavel;245369;139727;146445;270009;16163;286172;336073
4104907;PR;Castro;63581;33404;33678;49254;17828;67082;72125
4105003;PR;Catanduvas;10421;5192;5016;5344;4864;10208;10144
4105102;PR;Centenário do Sul;11817;5553;5625;9327;1851;11178;10704
4105201;PR;Cerro Azul;16352;8725;8223;4814;12134;16948;17884
4105300;PR;Céu Azul;10445;5413;5619;8387;2645;11032;11872
4105409;PR;Chopinzinho;20543;9769;9904;12503;7170;19673;19083
4105508;PR;Cianorte;57401;34042;35920;62282;7680;69962;84980
4105607;PR;Cidade Gaúcha;9531;5534;5533;9181;1886;11067;12939
4105706;PR;Clevelândia;18338;8438;8794;14756;2476;17232;16344
4105805;PR;Colombo;183329;105039;107988;203251;9776;213027;249277
4105904;PR;Colorado;20957;11045;11302;21007;1340;22347;24271
4106001;PR;Congonhinhas;7851;4237;4042;4834;3445;8279;8896
4106100;PR;Conselheiro Mairinck;3463;1830;1797;2513;1114;3627;3891
4106209;PR;Contenda;13241;8099;7793;9233;6659;15892;19082
4106308;PR;Corbélia;15803;7965;8337;13964;2338;16302;17162
4106407;PR;Cornélio Procópio;46861;22698;24227;44305;2620;46925;47840
4106456;PR;Coronel Domingos Soares;7004;3792;3446;1753;5485;7238;7538
4106506;PR;Coronel Vivida;23306;10613;11124;15432;6305;21737;20430
4106555;PR;Corumbataí do Sul;4946;2034;1969;2128;1875;4003;3038
4106571;PR;Cruzeiro do Iguaçu;4394;2131;2143;2619;1655;4274;4229
4106605;PR;Cruzeiro do Oeste;20222;9992;10427;17667;2752;20419;20962
4106704;PR;Cruzeiro do Sul;4759;2310;2253;3404;1159;4563;4430
4106803;PR;Cruz Machado;17667;9328;8715;6057;11986;18043;18772
4106852;PR;Cruzmaltina;3459;1635;1527;1503;1659;3162;2892
4106902;PR;Curitiba;1587315;832500;914396;1746896;0;1746896;1963726
4107009;PR;Curiúva;12904;7105;6819;9576;4348;13924;15289
4107108;PR;Diamante do Norte;6099;2735;2789;4559;965;5524;4975
4107124;PR;Diamante do Sul;3659;1795;1715;1405;2105;3510;3409
4107157;PR;Diamante DOeste;4878;2570;2457;2561;2466;5027;5279
4107207;PR;Dois Vizinhos;31986;17995;18203;28115;8083;36198;41424
4107256;PR;Douradina;6160;3770;3676;5233;2213;7446;8988
4107306;PR;Doutor Camargo;5777;2870;2959;5111;718;5829;5987
4107405;PR;Enéas Marques;6382;3130;2971;2126;3975;6101;5906
4107504;PR;Engenheiro Beltrão;14082;6929;6991;12288;1632;13920;13962
4107520;PR;Esperança Nova;2308;981;989;752;1218;1970;1633
4107538;PR;Entre Rios do Oeste;3328;1953;1969;2641;1281;3922;4651
4107546;PR;Espigão Alto do Iguaçu;5388;2386;2291;1646;3031;4677;3980
4107553;PR;Farol;3963;1723;1749;2018;1454;3472;2995
4107603;PR;Faxinal;15608;8028;8289;12745;3572;16317;17379
4107652;PR;Fazenda Rio Grande;62877;40580;41107;75940;5747;81687;103750
4107702;PR;Fênix;4942;2397;2405;3993;809;4802;4734
4107736;PR;Fernandes Pinheiro;6368;3039;2893;2094;3838;5932;5561
4107751;PR;Figueira;9038;4103;4190;7091;1202;8293;7625
4107801;PR;Floraí;5285;2502;2548;4472;578;5050;4883
4107850;PR;Flor da Serra do Sul;5059;2398;2327;1644;3081;4725;4583
4107900;PR;Floresta;5122;2943;2978;5471;450;5921;6926
4108007;PR;Florestópolis;12190;5684;5536;10546;674;11220;10360
4108106;PR;Flórida;2434;1287;1253;2322;218;2540;2709
4108205;PR;Formosa do Oeste;8755;3787;3756;4964;2579;7543;6345
4108304;PR;Foz do Iguaçu;258543;124203;131878;253950;2131;256081;257971
4108320;PR;Francisco Alves;6956;3227;3197;4240;2184;6424;5942
4108403;PR;Francisco Beltrão;67132;38971;39986;67456;11501;78957;93308
4108452;PR;Foz do Jordão;6378;2683;2731;3924;1490;5414;4466
4108502;PR;General Carneiro;13899;6898;6769;9569;4098;13667;13661
4108551;PR;Godoy Moreira;3836;1701;1636;1547;1790;3337;2850
4108601;PR;Goioerê;29750;14009;15015;25248;3776;29024;28734
4108650;PR;Goioxim;8086;3925;3579;1756;5748;7504;6997
4108700;PR;Grandes Rios;7868;3381;3244;3562;3063;6625;5379
4108809;PR;Guaíra;28659;14925;15744;28176;2493;30669;33497
4108908;PR;Guairaçá;5898;3106;3088;4957;1237;6194;6635
4108957;PR;Guamiranga;7134;4009;3891;2236;5664;7900;8881
4109005;PR;Guapirama;4068;1929;1957;2904;982;3886;3767
4109104;PR;Guaporema;2244;1134;1084;1280;938;2218;2239
4109203;PR;Guaraci;4919;2582;2665;4214;1033;5247;5557
4109302;PR;Guaraniaçu;17201;7261;7322;7800;6783;14583;11969
4109401;PR;Guarapuava;155161;81901;85562;153098;14365;167463;183755
4109500;PR;Guaraqueçaba;8288;4179;3691;2680;5190;7870;7554
4109609;PR;Guaratuba;27257;15972;16116;28793;3295;32088;37974
4109658;PR;Honório Serpa;6896;3095;2865;1991;3969;5960;5030
4109708;PR;Ibaiti;26448;14460;14265;23097;5628;28725;31854
4109757;PR;Ibema;5872;3036;3030;4941;1125;6066;6387
4109807;PR;Ibiporã;42153;23442;24758;45896;2304;48200;55688
4109906;PR;Icaraíma;10048;4458;4381;6240;2599;8839;7671
4110003;PR;Iguaraçu;3598;2010;1982;3569;423;3992;4475
4110052;PR;Iguatu;2255;1136;1097;1438;795;2233;2251
4110078;PR;Imbaú;9474;5748;5528;7067;4209;11276;13449
4110102;PR;Imbituva;24496;14391;14064;17888;10567;28455;33306
4110201;PR;Inácio Martins;10963;5604;5339;6288;4655;10943;11117
4110300;PR;Inajá;2915;1528;1460;2761;227;2988;3122
4110409;PR;Indianópolis;4212;2189;2110;3148;1151;4299;4472
4110508;PR;Ipiranga;13308;7330;6823;4892;9261;14153;15327
4110607;PR;Iporã;16445;7379;7585;11775;3189;14964;13642
4110656;PR;Iracema do Oeste;2951;1320;1258;2002;576;2578;2216
4110706;PR;Irati;52352;27761;28527;45004;11284;56288;61439
4110805;PR;Iretama;11335;5422;5180;6177;4425;10602;10029
4110904;PR;Itaguajé;4771;2296;2272;3636;932;4568;4426
4110953;PR;Itaipulândia;6836;4547;4480;4742;4285;9027;11588
4111001;PR;Itambaracá;7090;3390;3369;5080;1679;6759;6516
4111100;PR;Itambé;5956;2948;3029;5669;308;5977;6110
4111209;PR;Itapejara dOeste;9162;5263;5269;6988;3544;10532;12220
4111258;PR;Itaperuçu;19344;11989;11910;19966;3933;23899;29493
4111308;PR;Itaúna do Sul;4447;1822;1763;2549;1036;3585;2700
4111407;PR;Ivaí;11899;6672;6134;4623;8183;12806;14049
4111506;PR;Ivaiporã;32270;15409;16403;27431;4381;31812;31886
4111555;PR;Ivaté;6925;3820;3704;5241;2283;7524;8294
4111605;PR;Ivatuba;2796;1435;1573;2294;714;3008;3299
4111704;PR;Jaboti;4590;2485;2410;3025;1870;4895;5332
4111803;PR;Jacarezinho;39625;19120;19973;34763;4330;39093;39268
4111902;PR;Jaguapitã;10932;6125;6131;10412;1844;12256;13861
4112009;PR;Jaguariaíva;30780;16097;16519;28051;4565;32616;35192
4112108;PR;Jandaia do Sul;19676;9898;10385;18337;1946;20283;21281
4112207;PR;Janiópolis;8084;3274;3262;4042;2494;6536;4948
4112306;PR;Japira;4901;2546;2364;2734;2176;4910;4929
4112405;PR;Japurá;7755;4319;4228;7614;933;8547;9573
4112504;PR;Jardim Alegre;13673;6272;6053;7175;5150;12325;11067
4112603;PR;Jardim Olinda;1523;699;710;1001;408;1409;1309
4112702;PR;Jataizinho;11327;5869;5990;11037;822;11859;12687
4112751;PR;Jesuítas;9832;4470;4531;6070;2931;9001;8251
4112801;PR;Joaquim Távora;9661;5319;5416;8219;2516;10735;12108
4112900;PR;Jundiaí do Sul;3659;1742;1691;1975;1458;3433;3248
4112959;PR;Juranda;8134;3815;3826;5839;1802;7641;7244
4113007;PR;Jussara;6299;3264;3349;5936;677;6613;7069
4113106;PR;Kaloré;5044;2281;2222;3217;1286;4503;3996
4113205;PR;Lapa;41838;22646;22290;27228;17708;44936;48651
4113254;PR;Laranjal;7121;3236;3125;2031;4330;6361;5719
4113304;PR;Laranjeiras do Sul;30025;14993;15790;25039;5744;30783;32167
4113403;PR;Leópolis;4440;2054;2091;2401;1744;4145;3896
4113429;PR;Lidianópolis;4783;1962;2010;2046;1926;3972;3155
4113452;PR;Lindoeste;6224;2793;2570;2384;2979;5363;4488
4113502;PR;Loanda;19549;10456;10755;19281;1930;21211;23393
4113601;PR;Lobato;4064;2224;2168;4099;293;4392;4850
4113700;PR;Londrina;447065;243017;263628;493457;13188;506645;580870
4113734;PR;Luiziana;7540;3742;3575;4762;2555;7317;7217
4113759;PR;Lunardelli;5668;2560;2596;3593;1563;5156;4695
4113809;PR;Lupionópolis;4323;2261;2331;4079;513;4592;4969
4113908;PR;Mallet;12602;6721;6252;7570;5403;12973;13697
4114005;PR;Mamborê;15156;6947;7021;8988;4980;13968;12900
4114104;PR;Mandaguaçu;16828;9855;9929;17570;2214;19784;23373
4114203;PR;Mandaguari;31395;16032;16637;30950;1719;32669;34628
4114302;PR;Mandirituba;17540;11338;10897;7419;14816;22235;27750
4114351;PR;Manfrinópolis;3802;1680;1447;652;2475;3127;2442
4114401;PR;Mangueirinha;17760;8433;8608;8386;8655;17041;16572
4114500;PR;Manoel Ribas;13066;6525;6639;6802;6362;13164;13517
4114609;PR;Marechal Cândido Rondon;41007;22833;23966;39134;7665;46799;54031
4114708;PR;Maria Helena;6384;2994;2962;3994;1962;5956;5593
4114807;PR;Marialva;28702;15797;16175;25794;6178;31972;36103
4114906;PR;Marilândia do Sul;9071;4495;4360;6312;2543;8855;8793
4115002;PR;Marilena;6756;3532;3322;4983;1871;6854;7093
4115101;PR;Mariluz;10296;5113;5111;8467;1757;10224;10327
4115200;PR;Maringá;288653;171748;185369;349120;7997;357117;436472
4115309;PR;Mariópolis;6017;3116;3153;4469;1800;6269;6655
4115358;PR;Maripá;5889;2843;2848;3267;2424;5691;5562
4115408;PR;Marmeleiro;13665;6916;6993;8835;5074;13909;14407
4115457;PR;Marquinho;5659;2611;2372;523;4460;4983;4283
4115507;PR;Marumbi;4612;2283;2316;3139;1460;4599;4676
4115606;PR;Matelândia;14344;7968;8109;11612;4465;16077;18266
4115705;PR;Matinhos;24184;14333;15093;29277;149;29426;35705
4115739;PR;Mato Rico;4496;2032;1790;961;2861;3822;3142
4115754;PR;Mauá da Serra;6471;4364;4189;7011;1542;8553;10994
4115804;PR;Medianeira;37827;20578;21252;37403;4427;41830;46940
4115853;PR;Mercedes;4608;2524;2522;2439;2607;5046;5617
4115903;PR;Mirador;2500;1181;1146;1579;748;2327;2180
4116000;PR;Miraselva;1961;922;936;1430;428;1858;1786
4116059;PR;Missal;10433;5269;5205;5420;5054;10474;10706
4116109;PR;Moreira Sales;13395;6315;6291;9933;2673;12606;11966
4116208;PR;Morretes;15275;7950;7768;7178;8540;15718;16485
4116307;PR;Munhoz de Melo;3401;1839;1839;2980;698;3678;4034
4116406;PR;Nossa Senhora das Graças;3833;1953;1881;3183;651;3834;4009
4116505;PR;Nova Aliança do Ivaí;1338;717;716;1043;390;1433;1560
4116604;PR;Nova América da Colina;3585;1770;1710;2526;954;3480;3424
4116703;PR;Nova Aurora;13641;5832;6039;9045;2826;11871;10131
4116802;PR;Nova Cantu;9914;3757;3668;4104;3321;7425;4827
4116901;PR;Nova Esperança;25729;13018;13595;24314;2299;26613;28062
4116950;PR;Nova Esperança do Sudoeste;5258;2662;2448;1753;3357;5110;5014
4117008;PR;Nova Fátima;8305;4037;4116;6615;1538;8153;8120
4117057;PR;Nova Laranjeiras;11699;5693;5546;2375;8864;11239;11462
4117107;PR;Nova Londrina;13169;6419;6650;12024;1045;13069;13188
4117206;PR;Nova Olímpia;5280;2694;2812;4688;818;5506;5846
4117214;PR;Nova Santa Bárbara;3611;1896;2015;3282;629;3911;4304
4117222;PR;Nova Santa Rosa;7125;3791;3834;5315;2310;7625;8311
4117255;PR;Nova Prata do Iguaçu;10397;5221;5148;6066;4303;10369;10540
4117271;PR;Nova Tebas;9476;3807;3582;2891;4498;7389;5252
4117297;PR;Novo Itacolomi;2866;1485;1342;1588;1239;2827;2836
4117305;PR;Ortigueira;25216;12067;11297;9574;13790;23364;21783
4117404;PR;Ourizona;3396;1703;1677;3042;338;3380;3423
4117453;PR;Ouro Verde do Oeste;5472;2865;2825;4040;1650;5690;6036
4117503;PR;Paiçandu;30764;17840;18101;35450;491;35941;42251
4117602;PR;Palmas;34819;21180;21707;39803;3084;42887;52503
4117701;PR;Palmeira;30847;16046;16079;19376;12749;32125;34109
4117800;PR;Palmital;16958;7515;7355;7403;7467;14870;12755
4117909;PR;Palotina;25771;14003;14689;24655;4037;28692;32389
4118006;PR;Paraíso do Norte;9739;5856;5925;11108;673;11781;14211
4118105;PR;Paranacity;9109;5115;5141;9475;781;10256;11685
4118204;PR;Paranaguá;127339;69301;71149;135405;5045;140450;157378
4118303;PR;Paranapoema;2393;1383;1408;2500;291;2791;3277
4118402;PR;Paranavaí;75750;39285;42310;77733;3862;81595;89454
4118451;PR;Pato Bragado;4049;2367;2456;2991;1832;4823;5755
4118501;PR;Pato Branco;62234;34984;37389;68093;4280;72373;84779
4118600;PR;Paula Freitas;5060;2800;2630;2748;2682;5430;5942
4118709;PR;Paulo Frontin;6565;3634;3279;2173;4740;6913;7418
4118808;PR;Peabiru;13487;6733;6889;11009;2613;13622;14017
4118857;PR;Perobal;5291;2824;2824;3081;2567;5648;6194
4118907;PR;Pérola;9282;5004;5204;8069;2139;10208;11406
4119004;PR;Pérola dOeste;7354;3403;3361;3190;3574;6764;6232
4119103;PR;Piên;9798;5745;5469;4514;6700;11214;13015
4119152;PR;Pinhais;102985;56895;60271;117166;0;117166;134788
4119202;PR;Pinhalão;6217;3163;3047;3921;2289;6210;6323
4119251;PR;Pinhal de São Bento;2560;1365;1255;1162;1458;2620;2742
4119301;PR;Pinhão;28408;15192;15041;15323;14910;30233;32722
4119400;PR;Piraí do Sul;21647;11621;11804;16104;7321;23425;25779
4119509;PR;Piraquara;72886;48220;45059;45779;47500;93279;116852
4119608;PR;Pitanga;35861;16247;16398;20587;12058;32645;29686
4119657;PR;Pitangueiras;2418;1441;1373;2040;774;2814;3298
4119707;PR;Planaltina do Paraná;3992;2074;2021;2774;1321;4095;4281
4119806;PR;Planalto;14122;6851;6817;6080;7588;13668;13385
4119905;PR;Ponta Grossa;273616;151429;160268;304841;6856;311697;358838
4119954;PR;Pontal do Paraná;14323;10355;10564;20742;177;20919;28529
4120002;PR;Porecatu;15881;7033;7150;11440;2743;14183;12587
4120101;PR;Porto Amazonas;4236;2255;2260;2949;1566;4515;4899
4120150;PR;Porto Barreiro;4206;1914;1745;688;2971;3659;3133
4120200;PR;Porto Rico;2550;1284;1247;1764;767;2531;2554
4120309;PR;Porto Vitória;4051;2066;1954;2229;1791;4020;4057
4120333;PR;Prado Ferreira;3152;1735;1699;3016;418;3434;3806
4120358;PR;Pranchita;6260;2817;2815;3609;2023;5632;5035
4120408;PR;Presidente Castelo Branco;4305;2449;2326;4188;587;4775;5395
4120507;PR;Primeiro de Maio;10728;5401;5431;10083;749;10832;11138
4120606;PR;Prudentópolis;46346;24893;23900;22458;26335;48793;52776
4120655;PR;Quarto Centenário;5333;2391;2465;2912;1944;4856;4420
4120705;PR;Quatiguá;6742;3455;3589;6371;673;7044;7504
4120804;PR;Quatro Barras;16161;9924;9862;17923;1863;19786;24253
4120853;PR;Quatro Pontes;3646;1849;1955;2436;1368;3804;4043
4120903;PR;Quedas do Iguaçu;27364;15385;15200;20988;9597;30585;34707
4121000;PR;Querência do Norte;11438;5940;5809;7627;4122;11749;12257
4121109;PR;Quinta do Sol;5759;2543;2542;3809;1276;5085;4444
4121208;PR;Quitandinha;15272;8838;8250;4886;12202;17088;19388
4121257;PR;Ramilândia;3868;2124;2010;2043;2091;4134;4500
4121307;PR;Rancho Alegre;4197;1953;2002;3470;485;3955;3760
4121356;PR;Rancho Alegre DOeste;3117;1415;1432;2303;544;2847;2602
4121406;PR;Realeza;16023;8005;8343;11808;4540;16348;16976
4121505;PR;Rebouças;13663;7201;6975;7505;6671;14176;14991
4121604;PR;Renascença;6959;3424;3386;3483;3327;6810;6772
4121703;PR;Reserva;23977;12927;12250;12211;12966;25177;26933
4121752;PR;Reserva do Iguaçu;6678;3763;3564;3921;3406;7327;8127
4121802;PR;Ribeirão Claro;10903;5278;5412;7093;3597;10690;10622
4121901;PR;Ribeirão do Pinhal;14341;6731;6791;11088;2434;13522;12869
4122008;PR;Rio Azul;13023;7340;6753;5012;9081;14093;15433
4122107;PR;Rio Bom;3546;1742;1592;2007;1327;3334;3162
4122156;PR;Rio Bonito do Iguaçu;13791;7064;6596;3325;10335;13660;13240
4122172;PR;Rio Branco do Ivaí;3758;1962;1935;919;2978;3897;4121
4122206;PR;Rio Branco do Sul;29341;15553;15109;22044;8618;30662;32635
4122305;PR;Rio Negro;28710;15556;15705;25700;5561;31261;34645
4122404;PR;Rolândia;49410;28462;29408;54758;3112;57870;68165
4122503;PR;Roncador;13632;5824;5720;7126;4418;11544;9447
4122602;PR;Rondon;8527;4569;4436;7200;1805;9005;9664
4122651;PR;Rosário do Ivaí;6585;2828;2758;2721;2865;5586;4595
4122701;PR;Sabáudia;5413;3050;3045;5096;999;6095;6954
4122800;PR;Salgado Filho;5338;2248;2155;2252;2151;4403;3389
4122909;PR;Salto do Itararé;5549;2614;2564;3723;1455;5178;4862
4123006;PR;Salto do Lontra;12757;6934;6738;7429;6243;13672;14957
4123105;PR;Santa Amélia;4407;1909;1895;2887;917;3804;3208
4123204;PR;Santa Cecília do Pavão;4064;1804;1842;3057;589;3646;3253
4123303;PR;Santa Cruz de Monte Castelo;8578;4054;4039;5744;2349;8093;7705
4123402;PR;Santa Fé;8870;5119;5317;9230;1206;10436;12330
4123501;PR;Santa Helena;20491;11507;11918;12596;10829;23425;27036
4123600;PR;Santa Inês;2099;927;891;1192;626;1818;1568
4123709;PR;Santa Isabel do Ivaí;9154;4383;4372;7056;1699;8755;8484
4123808;PR;Santa Izabel do Oeste;11711;6621;6513;7427;5707;13134;14924
4123824;PR;Santa Lúcia;4126;1959;1967;2537;1389;3926;3795
4123857;PR;Santa Maria do Oeste;13639;5911;5586;3209;8288;11497;9210
4123907;PR;Santa Mariana;13470;6174;6263;8323;4114;12437;11523
4123956;PR;Santa Mônica;3190;1845;1725;1475;2095;3570;4052
4124004;PR;Santana do Itararé;5638;2643;2606;3456;1793;5249;4916
4124020;PR;Santa Tereza do Oeste;10754;5247;5095;8038;2304;10342;10055
4124053;PR;Santa Terezinha de Itaipu;18368;10198;10636;18832;2002;20834;23927
4124103;PR;Santo Antônio da Platina;39943;20968;21720;36937;5751;42688;46503
4124202;PR;Santo Antônio do Caiuá;2878;1349;1383;2128;604;2732;2611
4124301;PR;Santo Antônio do Paraíso;2790;1203;1209;1826;586;2412;2032
4124400;PR;Santo Antônio do Sudoeste;17870;9279;9626;13712;5193;18905;20354
4124509;PR;Santo Inácio;5188;2663;2606;4200;1069;5269;5422
4124608;PR;São Carlos do Ivaí;5904;3255;3097;5679;673;6352;6961
4124707;PR;São Jerônimo da Serra;11750;5845;5491;5657;5679;11336;11088
4124806;PR;São João;11207;5243;5364;6746;3861;10607;10122
4124905;PR;São João do Caiuá;6091;2923;2986;5039;870;5909;5819
4125001;PR;São João do Ivaí;13196;5672;5851;8879;2644;11523;9897
4125100;PR;São João do Triunfo;12418;7208;6496;4048;9656;13704;15359
4125209;PR;São Jorge dOeste;9307;4546;4539;5214;3871;9085;9005
4125308;PR;São Jorge do Ivaí;5590;2725;2783;4772;736;5508;5535
4125357;PR;São Jorge do Patrocínio;6604;3067;2980;3542;2505;6047;5532
4125407;PR;São José da Boa Vista;6978;3365;3146;3864;2647;6511;6115
4125456;PR;São José das Palmeiras;4102;1927;1904;2412;1419;3831;3601
4125506;PR;São José dos Pinhais;204316;130211;133277;236233;27255;263488;334620
4125555;PR;São Manoel do Paraná;2072;1054;1044;1159;939;2098;2165
4125605;PR;São Mateus do Sul;36569;20782;20475;25706;15551;41257;47137
4125704;PR;São Miguel do Iguaçu;24432;12835;12920;16476;9279;25755;27696
4125753;PR;São Pedro do Iguaçu;7277;3291;3201;4056;2436;6492;5745
4125803;PR;São Pedro do Ivaí;9473;5107;5057;8038;2126;10164;11109
4125902;PR;São Pedro do Paraná;2738;1263;1231;1633;861;2494;2265
4126009;PR;São Sebastião da Amoreira;8548;4257;4372;7596;1033;8629;8865
4126108;PR;São Tomé;5045;2696;2653;4446;903;5349;5778
4126207;PR;Sapopema;6872;3507;3229;3552;3184;6736;6708
4126256;PR;Sarandi;71422;40839;42003;82155;687;82842;98888
4126272;PR;Saudade do Iguaçu;4608;2526;2481;2500;2507;5007;5578
4126306;PR;Sengés;17778;9462;8948;15108;3302;18410;19441
4126355;PR;Serranópolis do Iguaçu;4740;2229;2339;2322;2246;4568;4460
4126405;PR;Sertaneja;6521;2896;2921;5105;712;5817;5149
4126504;PR;Sertanópolis;15147;7753;7884;13716;1921;15637;16456
4126603;PR;Siqueira Campos;16000;9197;9249;13419;5027;18446;21476
4126652;PR;Sulina;3918;1713;1681;1390;2004;3394;2880
4126678;PR;Tamarana;9713;6253;5979;5857;6375;12232;15277
4126702;PR;Tamboara;4255;2309;2355;3995;669;4664;5196
4126801;PR;Tapejara;13120;7306;7294;13168;1432;14600;16480
4126900;PR;Tapira;6282;2918;2916;3434;2400;5834;5452
4127007;PR;Teixeira Soares;8192;5327;4950;4793;5484;10277;12761
4127106;PR;Telêmaco Borba;61238;34388;35490;68431;1447;69878;80588
4127205;PR;Terra Boa;14640;7831;7960;13057;2734;15791;17304
4127304;PR;Terra Rica;13797;7624;7632;12393;2863;15256;17054
4127403;PR;Terra Roxa;16300;8300;8463;12802;3961;16763;17562
4127502;PR;Tibagi;18434;9793;9539;11675;7657;19332;20688
4127601;PR;Tijucas do Sul;12260;7537;6989;2267;12259;14526;17295
4127700;PR;Toledo;98200;58359;60994;108287;11066;119353;144601
4127809;PR;Tomazina;9931;4528;4260;4119;4669;8788;7699
4127858;PR;Três Barras do Paraná;11822;5994;5830;6095;5729;11824;12036
4127882;PR;Tunas do Paraná;3611;3272;2986;2790;3468;6258;9269
4127908;PR;Tuneiras do Oeste;9013;4443;4254;5975;2722;8697;8502
4127957;PR;Tupãssi;8018;4053;3944;6286;1711;7997;8105
4127965;PR;Turvo;14530;6991;6847;5053;8785;13838;12977
4128005;PR;Ubiratã;22593;10509;11053;18400;3162;21562;20809
4128104;PR;Umuarama;90690;48818;51898;93489;7227;100716;113416
4128203;PR;União da Vitória;48522;25826;26927;50002;2751;52753;58298
4128302;PR;Uniflor;2362;1231;1234;1986;479;2465;2623
4128401;PR;Uraí;11876;5680;5792;9358;2114;11472;11233
4128500;PR;Wenceslau Braz;19559;9512;9782;15505;3789;19294;19358
4128534;PR;Ventania;8024;5147;4820;6515;3452;9967;12267
4128559;PR;Vera Cruz do Oeste;9651;4411;4562;6863;2110;8973;8389
4128609;PR;Verê;8721;3938;3941;3284;4595;7879;7094
4128625;PR;Alto Paraíso;3783;1619;1587;1772;1434;3206;2630
4128633;PR;Doutor Ulysses;6003;2980;2754;939;4795;5734;5525
4128658;PR;Virmond;3949;1999;1951;1880;2070;3950;4051
4128708;PR;Vitorino;6285;3228;3281;3981;2528;6509;6879
4128807;PR;Xambrê;6500;2998;3013;1991;4020;6011;5584
4200051;SC;Abdon Batista;2775;1382;1271;724;1929;2653;2534
4200101;SC;Abelardo Luz;16440;8628;8472;9570;7530;17100;18015
4200200;SC;Agrolândia;7810;4703;4625;5964;3364;9328;11160
4200309;SC;Agronômica;4257;2496;2405;1855;3046;4901;5570
4200408;SC;Água Doce;6843;3551;3409;3436;3524;6960;7160
4200507;SC;Águas de Chapecó;5782;3124;2985;3236;2873;6109;6544
4200556;SC;Águas Frias;2525;1279;1145;981;1443;2424;2341
4200606;SC;Águas Mornas;5390;2808;2738;2327;3219;5546;6646
4200705;SC;Alfredo Wagner;8857;4784;4626;2868;6542;9410;10136
4200754;SC;Alto Bela Vista;2098;1005;1000;605;1400;2005;1915
4200804;SC;Anchieta;7133;3231;3147;2588;3790;6378;5477
4200903;SC;Angelina;5776;2765;2485;1123;4127;5250;4686
4201000;SC;Anita Garibaldi;10273;4342;4285;4555;4072;8627;6783
4201109;SC;Anitápolis;3234;1675;1539;1315;1899;3214;3223
4201208;SC;Antônio Carlos;6434;3754;3701;2338;5117;7455;8712
4201257;SC;Apiúna;8520;4880;4725;4295;5310;9605;10951
4201273;SC;Arabutã;4160;2133;2060;1307;2886;4193;4268
4201307;SC;Araquari;23645;12640;12174;23359;1455;24814;40890
4201406;SC;Araranguá;54706;30154;31185;50551;10788;61339;69493
4201505;SC;Armazém;6873;3912;3818;4871;2859;7730;8843
4201604;SC;Arroio Trinta;3490;1746;1754;2397;1103;3500;3547
4201653;SC;Arvoredo;2305;1226;1030;497;1759;2256;2228
4201703;SC;Ascurra;6934;3682;3737;6460;959;7419;8021
4201802;SC;Atalanta;3429;1661;1639;1368;1932;3300;3179
4201901;SC;Aurora;5474;2825;2727;1931;3621;5552;5687
4201950;SC;Balneário Arroio do Silva;6043;4745;4845;9395;195;9590;13782
4202008;SC;Balneário Camboriú;73455;51393;56714;108107;0;108107;149227
4202057;SC;Balneário Barra do Sul;6045;4170;4253;8029;394;8423;11271
4202073;SC;Balneário Gaivota;5450;4091;4153;6371;1873;8244;11537
4202081;SC;Bandeirante;3177;1534;1372;932;1974;2906;2618
4202099;SC;Barra Bonita;2118;976;902;279;1599;1878;1625
4202107;SC;Barra Velha;15530;11122;11281;21337;1066;22403;30539
4202131;SC;Bela Vista do Toldo;5721;3104;2900;847;5157;6004;6386
4202156;SC;Belmonte;2588;1358;1277;1273;1362;2635;2712
4202206;SC;Benedito Novo;9071;5279;5052;5803;4528;10331;11896
4202305;SC;Biguaçu;48077;28691;29547;52806;5432;58238;70471
4202404;SC;Blumenau;261808;151648;157566;294968;14246;309214;366418
4202438;SC;Bocaina do Sul;2980;1700;1590;967;2323;3290;3501
4202453;SC;Bombinhas;8716;7207;7105;14312;0;14312;20889
4202503;SC;Bom Jardim da Serra;4079;2254;2146;2397;2003;4400;4801
4202537;SC;Bom Jesus;2046;1253;1273;1495;1031;2526;3104
4202578;SC;Bom Jesus do Oeste;2150;1078;1054;647;1485;2132;2136
4202602;SC;Bom Retiro;7967;4513;4429;6417;2525;8942;10153
4202701;SC;Botuverá;3756;2278;2190;1310;3158;4468;5396
4202800;SC;Braço do Norte;24802;14535;14483;23383;5635;29018;34294
4202859;SC;Braço do Trombudo;3187;1765;1692;1898;1559;3457;3794
4202875;SC;Brunópolis;3331;1451;1401;707;2145;2852;2318
4202909;SC;Brusque;76058;52400;53095;102017;3478;105495;140597
4203006;SC;Caçador;63322;35026;35709;64431;6304;70735;80017
4203105;SC;Caibi;6354;3143;3075;3578;2640;6218;6112
4203154;SC;Calmon;3467;1752;1628;2109;1271;3380;3325
4203204;SC;Camboriú;41445;31111;31178;59157;3132;62289;87179
4203253;SC;Capão Alto;3020;1431;1322;962;1791;2753;2467
4203303;SC;Campo Alegre;11634;5971;5777;7237;4511;11748;11985
4203402;SC;Campo Belo do Sul;8051;3850;3636;4410;3076;7486;6889
4203501;SC;Campo Erê;10353;4686;4684;6252;3118;9370;8312
4203600;SC;Campos Novos;28729;16257;16572;27065;5764;32829;36861
4203709;SC;Canelinha;9004;5372;5231;6726;3877;10603;12553
4203808;SC;Canoinhas;51631;26052;26723;39283;13492;52775;54558
4203907;SC;Capinzal;19955;10236;10535;17756;3015;20771;23218
4203956;SC;Capivari de Baixo;18561;10503;11186;19828;1861;21689;25477
4204004;SC;Catanduvas;8291;4770;4788;8094;1464;9558;11106
4204103;SC;Caxambu do Sul;5263;2218;2188;2150;2256;4406;3462
4204152;SC;Celso Ramos;2844;1396;1377;872;1901;2773;2709
4204178;SC;Cerro Negro;4098;1875;1710;764;2821;3585;3013
4204194;SC;Chapadão do Lageado;2561;1426;1338;515;2249;2764;3025
4204202;SC;Chapecó;146967;90638;92923;168159;15402;183561;227587
4204251;SC;Cocal do Sul;13726;7530;7641;12706;2465;15171;16956
4204301;SC;Concórdia;63058;33776;34851;54872;13755;68627;75683
4204350;SC;Cordilheira Alta;3093;1938;1849;1468;2319;3787;4585
4204400;SC;Coronel Freitas;10535;5189;5024;6067;4146;10213;9900
4204459;SC;Coronel Martins;2388;1260;1198;685;1773;2458;2560
4204509;SC;Corupá;11847;7002;6850;10669;3183;13852;16300
4204558;SC;Correia Pinto;17026;7381;7413;12021;2773;14794;12315
4204608;SC;Criciúma;170420;94554;97682;189558;2678;192236;219393
4204707;SC;Cunha Porã;10229;5259;5354;6519;4094;10613;11150
4204756;SC;Cunhataí;1822;1004;878;569;1313;1882;1972
4204806;SC;Curitibanos;36061;18536;19238;34796;2978;37774;40037
4204905;SC;Descanso;9129;4357;4281;4297;4341;8638;8136
4205001;SC;Dionísio Cerqueira;14250;7407;7394;10182;4619;14801;15592
4205100;SC;Dona Emma;3309;1912;1811;1868;1855;3723;4224
4205159;SC;Doutor Pedrinho;3082;1794;1810;2019;1585;3604;4164
4205175;SC;Entre Rios;2857;1557;1461;928;2090;3018;3232
4205191;SC;Ermo;2057;1066;984;619;1431;2050;2059
4205209;SC;Erval Velho;4269;2151;2202;2842;1511;4353;4423
4205308;SC;Faxinal dos Guedes;10767;5355;5303;7715;2943;10658;10630
4205357;SC;Flor do Sertão;1612;827;761;328;1260;1588;1575
4205407;SC;Florianópolis;342315;203093;218110;405243;15960;421203;516524
4205431;SC;Formosa do Sul;2725;1327;1274;1084;1517;2601;2481
4205456;SC;Forquilhinha;18348;11309;11239;18426;4122;22548;27621
4205506;SC;Fraiburgo;32948;17161;17394;30294;4261;34555;36723
4205555;SC;Frei Rogério;2971;1290;1190;706;1774;2480;1918
4205605;SC;Galvão;4235;1721;1754;2350;1125;3475;2711
4205704;SC;Garopaba;13164;9133;9011;15326;2818;18144;24070
4205803;SC;Garuva;11378;7539;7223;11462;3300;14762;18816
4205902;SC;Gaspar;46414;28675;29283;47107;10851;57958;71925
4206009;SC;Governador Celso Ramos;11598;6634;6378;12264;748;13012;14739
4206108;SC;Grão Pará;5817;3235;2988;3019;3204;6223;6621
4206207;SC;Gravatal;10799;5283;5353;4444;6192;10636;11652
4206306;SC;Guabiruba;12976;9352;9081;17069;1364;18433;24922
4206405;SC;Guaraciaba;11038;5298;5200;4919;5579;10498;9964
4206504;SC;Guaramirim;23794;17849;17337;28055;7131;35186;46757
4206603;SC;Guarujá do Sul;4696;2402;2506;2655;2253;4908;5196
4206652;SC;Guatambú;4702;2467;2208;1749;2926;4675;4692
4206702;SC;Herval dOeste;20044;10494;10739;18845;2388;21233;22820
4206751;SC;Ibiam;1955;981;964;695;1250;1945;1952
4206801;SC;Ibicaré;3587;1775;1598;1557;1816;3373;3154
4206900;SC;Ibirama;15802;8672;8670;14825;2517;17342;19238
4207007;SC;Içara;48634;29316;29543;53939;4920;58859;58055
4207106;SC;Ilhota;10574;6225;6131;7899;4457;12356;14531
4207205;SC;Imaruí;13404;5855;5817;4003;7669;11672;9764
4207304;SC;Imbituba;35700;19799;20401;40200;0;40200;45711
4207403;SC;Imbuia;5246;2891;2818;2517;3192;5709;6284
4207502;SC;Indaial;40194;27382;27412;52871;1923;54794;72346
4207577;SC;Iomerê;2553;1394;1349;911;1832;2743;2979
4207601;SC;Ipira;4979;2366;2386;2521;2231;4752;4367
4207650;SC;Iporã do Oeste;7877;4263;4150;4126;4287;8413;9093
4207684;SC;Ipuaçu;6122;3475;3327;1381;5421;6802;7643
4207700;SC;Ipumirim;6907;3665;3555;3148;4072;7220;7647
4207759;SC;Iraceminha;4592;2172;2081;1468;2785;4253;3901
4207809;SC;Irani;8602;4862;4672;6522;3012;9534;10575
4207858;SC;Irati;2202;1072;1024;449;1647;2096;1887
4207908;SC;Irineópolis;9734;5347;5103;3521;6929;10450;11354
4208005;SC;Itá;6764;3218;3209;4058;2369;6427;6091
4208104;SC;Itaiópolis;19086;10422;9893;10742;9573;20315;21889
4208203;SC;Itajaí;147494;90141;93247;173465;9923;183388;226617
4208302;SC;Itapema;25869;22387;23427;44676;1138;45814;69323
4208401;SC;Itapiranga;13998;7868;7562;7635;7795;15430;17139
4208450;SC;Itapoá;8839;7454;7321;14182;593;14775;21766
4208500;SC;Ituporanga;19492;11096;11159;14834;7421;22255;25619
4208609;SC;Jaborá;4194;2013;2028;1605;2436;4041;3899
4208708;SC;Jacinto Machado;10923;5262;5346;5132;5476;10608;10337
4208807;SC;Jaguaruna;14613;8624;8667;13199;4092;17291;20547
4208906;SC;Jaraguá do Sul;108489;71864;71342;132918;10288;143206;184579
4208955;SC;Jardinópolis;1994;900;866;799;967;1766;1520
4209003;SC;Joaçaba;24066;13008;13997;24918;2087;27005;30684
4209102;SC;Joinville;429604;255763;259487;497788;17462;515250;604708
4209151;SC;José Boiteux;4594;2391;2329;1610;3110;4720;5019
4209177;SC;Jupiá;2220;1094;1054;1044;1104;2148;2083
4209201;SC;Lacerdópolis;2173;1099;1098;1158;1039;2197;2248
4209300;SC;Lages;157682;75952;80785;153944;2793;156737;157158
4209409;SC;Laguna;47568;25308;26246;40659;10895;51554;46424
4209458;SC;Lajeado Grande;1572;756;734;648;842;1490;1408
4209508;SC;Laurentino;5062;3002;3003;4375;1630;6005;7154
4209607;SC;Lauro Muller;13604;7185;7181;11105;3261;14366;15380
4209706;SC;Lebon Régis;11682;6092;5770;7522;4340;11862;12122
4209805;SC;Leoberto Leal;3739;1754;1611;820;2545;3365;2960
4209854;SC;Lindóia do Sul;4877;2394;2248;1930;2712;4642;4530
4209904;SC;Lontras;8381;5128;5120;7018;3230;10248;12497
4210001;SC;Luiz Alves;7974;5390;5059;3256;7193;10449;13347
4210035;SC;Luzerna;5572;2738;2861;4258;1341;5599;5683
4210050;SC;Macieira;1900;948;878;501;1325;1826;1757
4210100;SC;Mafra;49940;26262;26658;41336;11584;52920;56825
4210209;SC;Major Gercino;3143;1672;1607;1249;2030;3279;3465
4210308;SC;Major Vieira;6906;3799;3680;2961;4518;7479;8209
4210407;SC;Maracajá;5541;3248;3161;4260;2149;6409;7461
4210506;SC;Maravilha;18521;10910;11194;18090;4014;22104;26463
4210555;SC;Marema;2651;1135;1068;760;1443;2203;1703
4210605;SC;Massaranduba;12562;7443;7225;7607;7061;14668;17330
4210704;SC;Matos Costa;3204;1473;1365;1462;1376;2838;2442
4210803;SC;Meleiro;7080;3458;3544;3651;3351;7002;6989
4210852;SC;Mirim Doce;2753;1273;1240;1202;1311;2513;2257
4210902;SC;Modelo;3930;2070;1977;2694;1353;4047;4227
4211009;SC;Mondaí;8728;5424;4807;6305;3926;10231;12034
4211058;SC;Monte Carlo;8579;4740;4572;8076;1236;9312;9945
4211108;SC;Monte Castelo;8350;4281;4067;4850;3498;8348;8263
4211207;SC;Morro da Fumaça;14551;8078;8048;13863;2263;16126;18095
4211256;SC;Morro Grande;2917;1513;1377;756;2134;2890;2884
4211306;SC;Navegantes;39317;30166;30422;57435;3153;60588;85734
4211405;SC;Nova Erechim;3543;2205;2070;3211;1064;4275;5163
4211454;SC;Nova Itaberaba;4256;2210;2057;1530;2737;4267;4327
4211504;SC;Nova Trento;9852;6177;6002;9121;3058;12179;15010
4211603;SC;Nova Veneza;11511;6720;6596;8928;4388;13316;15515
4211652;SC;Novo Horizonte;3101;1450;1300;921;1829;2750;2366
4211702;SC;Orleans;20031;10635;10760;16086;5309;21395;23161
4211751;SC;Otacílio Costa;13993;8265;8083;14902;1446;16348;19201
4211801;SC;Ouro;7419;3670;3701;4843;2528;7371;7251
4211850;SC;Ouro Verde;2352;1150;1121;715;1556;2271;2197
4211876;SC;Paial;2052;939;824;336;1427;1763;1444
4211892;SC;Painel;2384;1232;1121;945;1408;2353;2352
4211900;SC;Palhoça;102742;68332;68867;135229;1970;137199;178679
4212007;SC;Palma Sola;8206;3957;3808;4468;3297;7765;7321
4212056;SC;Palmeira;2133;1224;1152;925;1451;2376;2673
4212106;SC;Palmitos;16034;8016;8005;9871;6150;16021;16144
4212205;SC;Papanduva;16822;9184;8747;9185;8746;17931;19521
4212239;SC;Paraíso;4796;2091;1989;1451;2629;4080;3284
4212254;SC;Passo de Torres;4400;3354;3277;5877;754;6631;9269
4212270;SC;Passos Maia;4763;2246;2183;1102;3327;4429;4072
4212304;SC;Paulo Lopes;5924;3404;3288;4820;1872;6692;7642
4212403;SC;Pedras Grandes;4921;2098;2009;1261;2846;4107;3931
4212502;SC;Penha;17678;12541;12599;23058;2082;25140;34022
4212601;SC;Peritiba;3230;1484;1504;1481;1507;2988;2733
4212650;SC;Pescaria Brava;0;0;0;0;0;0;10225
4212700;SC;Petrolândia;6406;3166;2965;2225;3906;6131;5873
4212809;SC;Balneário Piçarras;10911;8521;8553;15502;1572;17074;24385
4212908;SC;Pinhalzinho;12356;8180;8155;13618;2717;16335;21103
4213005;SC;Pinheiro Preto;2729;1615;1532;1700;1447;3147;3635
4213104;SC;Piratuba;5812;2374;2412;2855;1931;4786;3637
4213153;SC;Planalto Alegre;2452;1383;1276;1066;1593;2659;2907
4213203;SC;Pomerode;22127;13906;13866;23836;3936;27772;34561
4213302;SC;Ponte Alta;5168;2454;2441;3577;1318;4895;4619
4213351;SC;Ponte Alta do Norte;3221;1644;1659;3007;296;3303;3426
4213401;SC;Ponte Serrada;10561;5537;5494;7624;3407;11031;11674
4213500;SC;Porto Belo;10704;8013;8105;15203;915;16118;22466
4213609;SC;Porto União;31858;16452;17045;28280;5217;33497;35685
4213708;SC;Pouso Redondo;12203;7504;7308;9026;5786;14812;17965
4213807;SC;Praia Grande;7286;3659;3611;4300;2970;7270;7305
4213906;SC;Presidente Castello Branco;2160;880;844;552;1172;1724;1526
4214003;SC;Presidente Getúlio;12333;7405;7481;10533;4353;14886;17973
4214102;SC;Presidente Nereu;2305;1167;1117;808;1476;2284;2279
4214151;SC;Princesa;2613;1421;1337;1004;1754;2758;2950
4214201;SC;Quilombo;10736;5170;5081;5749;4502;10251;9773
4214300;SC;Rancho Queimado;2637;1398;1350;1290;1458;2748;2897
4214409;SC;Rio das Antas;6129;3162;2985;2741;3406;6147;6199
4214508;SC;Rio do Campo;6522;3180;3015;2632;3563;6195;5864
4214607;SC;Rio do Oeste;6730;3608;3486;3390;3704;7094;7552
4214706;SC;Rio dos Cedros;8939;5267;5013;5122;5158;10280;11937
4214805;SC;Rio do Sul;51650;29972;31224;56783;4413;61196;72931
4214904;SC;Rio Fortuna;4320;2294;2152;1523;2923;4446;4630
4215000;SC;Rio Negrinho;37707;19980;19869;36351;3498;39849;42684
4215059;SC;Rio Rufino;2414;1245;1191;688;1748;2436;2484
4215075;SC;Riqueza;5166;2498;2340;2154;2684;4838;4525
4215109;SC;Rodeio;10380;5484;5430;9416;1498;10914;11647
4215208;SC;Romelândia;6491;2793;2758;2008;3543;5551;4584
4215307;SC;Salete;7163;3770;3587;4978;2379;7357;7674
4215356;SC;Saltinho;4196;2040;1921;1255;2706;3961;3727
4215406;SC;Salto Veloso;3910;2189;2112;3402;899;4301;4792
4215455;SC;Sangão;8128;5324;5078;4856;5546;10402;13128
4215505;SC;Santa Cecília;14802;7836;7904;13644;2096;15740;17004
4215554;SC;Santa Helena;2588;1236;1146;882;1500;2382;2178
4215604;SC;Santa Rosa de Lima;2007;1092;973;518;1547;2065;2151
4215653;SC;Santa Rosa do Sul;7810;4050;4004;3746;4308;8054;8397
4215679;SC;Santa Terezinha;8840;4700;4067;1513;7254;8767;8760
4215687;SC;Santa Terezinha do Progresso;3416;1493;1403;539;2357;2896;2317
4215695;SC;Santiago do Sul;1696;754;711;650;815;1465;1211
4215703;SC;Santo Amaro da Imperatriz;15708;9986;9844;14977;4853;19830;23907
4215752;SC;São Bernardino;3140;1408;1271;719;1960;2679;2239
4215802;SC;São Bento do Sul;65437;37229;37568;71230;3567;74797;86317
4215901;SC;São Bonifácio;3218;1551;1457;685;2323;3008;2791
4216008;SC;São Carlos;9364;5172;5112;6899;3385;10284;11456
4216057;SC;São Cristovão do Sul;4504;2853;2166;3806;1213;5019;5646
4216107;SC;São Domingos;9540;4783;4713;6313;3183;9496;9422
4216206;SC;São Francisco do Sul;32301;21191;21378;39536;3033;42569;54751
4216255;SC;São João do Oeste;5789;3098;2937;2118;3917;6035;6423
4216305;SC;São João Batista;14861;13287;12973;23551;2709;26260;39719
4216354;SC;São João do Itaperiú;3161;1792;1646;1928;1510;3438;3784
4216404;SC;São João do Sul;6784;3530;3472;1572;5430;7002;7332
4216503;SC;São Joaquim;22836;12434;12378;17573;7239;24812;27322
4216602;SC;São José;173559;101794;108719;208017;2496;210513;253705
4216701;SC;São José do Cedro;13678;6887;6785;8431;5241;13672;13811
4216800;SC;São José do Cerrito;10393;4801;4472;2492;6781;9273;8054
4216909;SC;São Lourenço do Oeste;19647;10830;10967;16885;4912;21797;24501
4217006;SC;São Ludgero;8587;5625;5368;9863;1130;10993;13886
4217105;SC;São Martinho;3274;1661;1550;1229;1982;3211;3162
4217154;SC;São Miguel da Boa Vista;2018;979;925;439;1465;1904;1794
4217204;SC;São Miguel do Oeste;32324;17639;18656;32052;4243;36295;41246
4217253;SC;São Pedro de Alcântara;3584;2994;1716;3735;975;4710;6046
4217303;SC;Saudades;8324;4618;4398;5123;3893;9016;9874
4217402;SC;Schroeder;10811;7801;7515;13703;1613;15316;22605
4217501;SC;Seara;16484;8518;8404;11589;5333;16922;17610
4217550;SC;Serra Alta;3330;1634;1651;1835;1450;3285;3249
4217600;SC;Siderópolis;12082;6479;6516;10051;2944;12995;14176
4217709;SC;Sombrio;22962;13080;13546;19650;6976;26626;31084
4217758;SC;Sul Brasil;3116;1438;1328;1011;1755;2766;2386
4217808;SC;Taió;16257;8691;8574;9973;7292;17265;18576
4217907;SC;Tangará;8754;4470;4204;4984;3690;8674;8648
4217956;SC;Tigrinhos;1878;902;855;343;1414;1757;1606
4218004;SC;Tijucas;23499;15497;15476;26012;4961;30973;39889
4218103;SC;Timbé do Sul;5323;2693;2615;1845;3463;5308;5338
4218202;SC;Timbó;29358;18265;18552;34333;2484;36817;45703
4218251;SC;Timbó Grande;6501;3610;3555;4081;3084;7165;8003
4218301;SC;Três Barras;17124;9058;9073;15367;2764;18131;19455
4218350;SC;Treviso;3144;1789;1738;1833;1694;3527;4002
4218400;SC;Treze de Maio;6716;3451;3426;3401;3476;6877;7104
4218509;SC;Treze Tílias;4840;3150;3192;4716;1626;6342;8138
4218608;SC;Trombudo Central;5795;3268;3286;4102;2452;6554;7506
4218707;SC;Tubarão;88470;47147;50134;88137;9144;97281;107143
4218756;SC;Tunápolis;4777;2369;2264;1418;3215;4633;4507
4218806;SC;Turvo;10887;5849;6005;7915;3939;11854;13080
4218855;SC;União do Oeste;3391;1475;1435;1107;1803;2910;2364
4218905;SC;Urubici;10252;5393;5309;7069;3633;10702;11311
4218954;SC;Urupema;2527;1274;1208;1232;1250;2482;2453
4219002;SC;Urussanga;18727;9934;10288;11404;8818;20222;21419
4219101;SC;Vargeão;3526;1786;1749;1824;1711;3535;3569
4219150;SC;Vargem;3225;1446;1362;896;1912;2808;2387
4219176;SC;Vargem Bonita;5158;2429;2366;2677;2118;4795;4411
4219200;SC;Vidal Ramos;6279;3260;3033;1792;4501;6293;6321
4219309;SC;Videira;41589;23290;23914;42872;4332;47204;54145
4219358;SC;Vitor Meireles;5519;2772;2436;1445;3763;5208;4907
4219408;SC;Witmarsum;3251;1828;1773;845;2756;3601;4032
4219507;SC;Xanxerê;37429;21571;22531;39123;4979;44102;52290
4219606;SC;Xavantina;4404;2159;1983;1118;3024;4142;3873
4219705;SC;Xaxim;22857;12763;12934;20953;4744;25697;29254
4219853;SC;Zortéa;2633;1537;1454;2336;655;2991;3432
4220000;SC;Balneário Rincão;0;0;0;0;0;0;13129
4300034;RS;Aceguá;0;2303;2091;1059;3335;4394;4981
4300059;RS;Água Santa;4127;1880;1846;1447;2279;3726;3738
4300109;RS;Agudo;17455;8353;8376;6894;9835;16729;16344
4300208;RS;Ajuricaba;7709;3585;3670;4108;3147;7255;6951
4300307;RS;Alecrim;8487;3512;3533;2165;4880;7045;5710
4300406;RS;Alegrete;84338;38055;39618;69611;8062;77673;72493
4300455;RS;Alegria;5367;2149;2152;1585;2716;4301;3287
4300471;RS;Almirante Tamandaré do Sul;0;1038;1024;834;1228;2062;1935
4300505;RS;Alpestre;10266;4129;3898;2211;5816;8027;5885
4300554;RS;Alto Alegre;2137;943;905;743;1105;1848;1590
4300570;RS;Alto Feliz;2834;1503;1405;813;2095;2908;3043
4300604;RS;Alvorada;183968;95105;100613;195718;0;195718;212352
4300638;RS;Amaral Ferrador;5740;3282;3073;1866;4489;6355;7136
4300646;RS;Ametista do Sul;7414;3732;3591;3811;3512;7323;7396
4300661;RS;André da Rocha;1113;620;596;496;720;1216;1351
4300703;RS;Anta Gorda;6327;3027;3046;2331;3742;6073;5941
4300802;RS;Antônio Prado;12918;6407;6430;9235;3602;12837;13041
4300851;RS;Arambaré;3917;1854;1839;2913;780;3693;3544
4300877;RS;Araricá;4032;2458;2410;4000;868;4868;5840
4300901;RS;Aratiba;7116;3341;3227;3316;3252;6568;6145
4301008;RS;Arroio do Meio;16951;9353;9430;14663;4120;18783;21121
4301057;RS;Arroio do Sal;5273;3832;3912;7513;231;7744;10483
4301073;RS;Arroio do Padre;0;1415;1315;454;2276;2730;2966
4301107;RS;Arroio dos Ratos;13335;6636;6972;12958;650;13608;14201
4301206;RS;Arroio do Tigre;12216;6384;6264;5962;6686;12648;13452
4301305;RS;Arroio Grande;19152;9175;9294;16086;2383;18469;18185
4301404;RS;Arvorezinha;10262;5138;5091;6277;3952;10229;10422
4301503;RS;Augusto Pestana;8173;3487;3610;3657;3440;7097;6545
4301552;RS;Áurea;3889;1807;1858;1537;2128;3665;3517
4301602;RS;Bagé;118767;55794;60998;97762;19030;116792;121518
4301636;RS;Balneário Pinhal;7452;5346;5509;10742;113;10855;14645
4301651;RS;Barão;5397;2910;2832;2967;2775;5742;6232
4301701;RS;Barão de Cotegipe;6927;3296;3233;3966;2563;6529;6616
4301750;RS;Barão do Triunfo;6662;3740;3278;697;6321;7018;7550
4301800;RS;Barracão;5592;2691;2664;3035;2320;5355;5237
4301859;RS;Barra do Guarita;2987;1550;1539;1371;1718;3089;3266
4301875;RS;Barra do Quaraí;3884;2130;1886;2840;1176;4016;4238
4301909;RS;Barra do Ribeiro;11845;6252;6316;9291;3277;12568;13618
4301925;RS;Barra do Rio Azul;2414;1049;954;403;1600;2003;1621
4301958;RS;Barra Funda;2231;1177;1190;1522;845;2367;2563
4302006;RS;Barros Cassal;11347;5729;5404;3531;7602;11133;11167
4302055;RS;Benjamin Constant do Sul;2727;1195;1112;341;1966;2307;1924
4302105;RS;Bento Gonçalves;91486;52713;54628;99121;8220;107341;123090
4302154;RS;Boa Vista das Missões;2188;1056;1058;886;1228;2114;2087
4302204;RS;Boa Vista do Buricá;6587;3294;3282;4368;2208;6576;6712
4302220;RS;Boa Vista do Cadeado;0;1257;1184;472;1969;2441;2466
4302238;RS;Boa Vista do Incra;0;1243;1182;724;1701;2425;2628
4302253;RS;Boa Vista do Sul;2840;1467;1311;391;2387;2778;2773
4302303;RS;Bom Jesus;12014;5720;5836;8595;2961;11556;11270
4302352;RS;Bom Princípio;9494;6031;5761;9201;2591;11792;14446
4302378;RS;Bom Progresso;2831;1167;1161;1146;1182;2328;1858
4302402;RS;Bom Retiro do Sul;10788;5655;5817;9162;2310;11472;12448
4302451;RS;Boqueirão do Leão;7825;3937;3736;1672;6001;7673;7691
4302501;RS;Bossoroca;7757;3510;3377;3682;3205;6887;6135
4302584;RS;Bozano;0;1100;1100;629;1571;2200;2099
4302600;RS;Braga;4198;1866;1836;2282;1420;3702;3271
4302659;RS;Brochier;4372;2399;2278;2296;2381;4677;5132
4302709;RS;Butiá;20322;10032;10373;19331;1074;20405;20963
4302808;RS;Caçapava do Sul;34643;16333;17367;25420;8280;33700;33476
4302907;RS;Cacequi;15311;6839;6846;11964;1721;13685;12291
4303004;RS;Cachoeira do Sul;87873;40381;43446;71699;12128;83827;81552
4303103;RS;Cachoeirinha;107564;57162;61132;118294;0;118294;132144
4303202;RS;Cacique Doble;4770;2412;2453;1626;3239;4865;5083
4303301;RS;Caibaté;7243;2532;2422;2745;2209;4954;4802
4303400;RS;Caiçara;5580;2585;2486;1594;3477;5071;4659
4303509;RS;Camaquã;60383;30895;31864;49355;13404;62759;66686
4303558;RS;Camargo;2498;1291;1300;1095;1496;2591;2750
4303608;RS;Cambará do Sul;6840;3350;3195;3041;3504;6545;6383
4303673;RS;Campestre da Serra;3170;1674;1573;1232;2015;3247;3402
4303707;RS;Campina das Missões;7014;3055;3062;2188;3929;6117;5325
4303806;RS;Campinas do Sul;8258;2651;2858;4220;1289;5509;5422
4303905;RS;Campo Bom;54018;29474;30607;57345;2736;60081;69981
4304002;RS;Campo Novo;6721;2684;2775;4109;1350;5459;4273
4304101;RS;Campos Borges;3785;1754;1740;2006;1488;3494;3272
4304200;RS;Candelária;29585;14756;15420;15715;14461;30176;31475
4304309;RS;Cândido Godói;7092;3318;3217;1846;4689;6535;6106
4304358;RS;Candiota;8065;4486;4290;2600;6176;8776;9707
4304408;RS;Canela;33625;19127;20111;35840;3398;39238;45957
4304507;RS;Canguçu;51447;26857;26411;19696;33572;53268;56370
4304606;RS;Canoas;306093;156014;168011;324025;0;324025;349728
4304614;RS;Canudos do Vale;0;959;848;411;1396;1807;1693
4304622;RS;Capão Bonito do Sul;0;942;811;499;1254;1753;1628
4304630;RS;Capão da Canoa;30498;20625;21422;41794;253;42047;55009
4304655;RS;Capão do Cipó;0;1625;1482;519;2588;3107;3745
4304663;RS;Capão do Leão;23718;11962;12332;22378;1916;24294;25462
4304671;RS;Capivari do Sul;3107;1935;1955;3230;660;3890;4793
4304689;RS;Capela de Santana;10032;5845;5768;6915;4698;11613;12183
4304697;RS;Capitão;2565;1353;1283;1147;1489;2636;2770
4304705;RS;Carazinho;59894;28267;31034;58237;1064;59301;62413
4304713;RS;Caraá;6403;3798;3515;1058;6255;7313;8426
4304804;RS;Carlos Barbosa;20519;12663;12530;19993;5200;25193;30630
4304853;RS;Carlos Gomes;1912;833;774;378;1229;1607;1327
4304903;RS;Casca;8440;4241;4407;5087;3561;8648;9070
4304952;RS;Caseiros;2899;1517;1490;1488;1519;3007;3228
4305009;RS;Catuípe;10198;4590;4733;5998;3325;9323;8631
4305108;RS;Caxias do Sul;360419;213547;221935;419321;16161;435482;523716
4305116;RS;Centenário;3127;1542;1425;949;2018;2967;2865
4305124;RS;Cerrito;6925;3214;3190;3747;2657;6404;6005
4305132;RS;Cerro Branco;4297;2225;2229;1274;3180;4454;4720
4305157;RS;Cerro Grande;2601;1209;1208;830;1587;2417;2281
4305173;RS;Cerro Grande do Sul;8273;5361;4919;2486;7794;10280;12579
4305207;RS;Cerro Largo;12665;6617;6672;10571;2718;13289;14243
4305306;RS;Chapada;9746;4593;4784;5573;3804;9377;9211
4305355;RS;Charqueadas;29961;19574;15789;34533;830;35363;41705
4305371;RS;Charrua;3783;1728;1743;584;2887;3471;3228
4305405;RS;Chiapetta;4481;1975;2069;2470;1574;4044;3684
4305439;RS;Chuí;5167;2922;2997;5699;220;5919;6832
4305447;RS;Chuvisca;4502;2603;2341;273;4671;4944;5518
4305454;RS;Cidreira;8882;6231;6423;12251;403;12654;16897
4305504;RS;Ciríaco;5252;2512;2410;2494;2428;4922;4693
4305587;RS;Colinas;2462;1209;1211;1105;1315;2420;2466
4305603;RS;Colorado;4072;1727;1823;1844;1706;3550;3088
4305702;RS;Condor;6491;3217;3335;4034;2518;6552;6766
4305801;RS;Constantina;11667;4769;4972;6497;3244;9741;9903
4305835;RS;Coqueiro Baixo;0;791;737;282;1246;1528;1490
4305850;RS;Coqueiros do Sul;2695;1255;1202;904;1553;2457;2267
4305871;RS;Coronel Barros;2454;1219;1240;1093;1366;2459;2521
4305900;RS;Coronel Bicaco;8435;3801;3947;5068;2680;7748;7213
4305934;RS;Coronel Pilar;0;893;832;174;1551;1725;1602
4305959;RS;Cotiporã;4093;2033;1884;2048;1869;3917;3824
4305975;RS;Coxilha;2979;1388;1438;1739;1087;2826;2731
4306007;RS;Crissiumal;15180;6914;7171;6124;7961;14085;13269
4306056;RS;Cristal;6632;3686;3594;4077;3203;7280;8121
4306072;RS;Cristal do Sul;2874;1441;1385;931;1895;2826;2840
4306106;RS;Cruz Alta;71254;29744;33081;60598;2227;62825;59561
4306130;RS;Cruzaltense;0;1101;1040;489;1652;2141;1765
4306205;RS;Cruzeiro do Sul;11664;6160;6171;7478;4853;12331;12457
4306304;RS;David Canabarro;4740;2410;2273;1912;2771;4683;4732
4306320;RS;Derrubadas;3715;1604;1586;901;2289;3190;2718
4306353;RS;Dezesseis de Novembro;3444;1469;1397;667;2199;2866;2331
4306379;RS;Dilermando de Aguiar;3200;1579;1485;991;2073;3064;2991
4306403;RS;Dois Irmãos;22435;13651;13921;27276;296;27572;33547
4306429;RS;Dois Irmãos das Missões;2365;1080;1077;1094;1063;2157;1992
4306452;RS;Dois Lajeados;3224;1654;1626;1563;1717;3280;3410
4306502;RS;Dom Feliciano;13297;7398;6982;3334;11046;14380;15556
4306551;RS;Dom Pedro de Alcântara;2636;1342;1208;739;1811;2550;2520
4306601;RS;Dom Pedrito;40410;19119;19797;35275;3641;38916;38222
4306700;RS;Dona Francisca;3902;1678;1723;2146;1255;3401;2958
4306734;RS;Doutor Maurício Cardoso;6329;2646;2667;2619;2694;5313;4380
4306759;RS;Doutor Ricardo;2128;1035;995;693;1337;2030;1967
4306767;RS;Eldorado do Sul;27268;16997;17338;30792;3543;34335;42490
4306809;RS;Encantado;18528;9931;10583;17883;2631;20514;23047
4306908;RS;Encruzilhada do Sul;23902;12321;12216;17117;7420;24537;26039
4306924;RS;Engenho Velho;2134;744;786;602;928;1530;932
4306932;RS;Entre-Ijuís;9702;4415;4523;4893;4045;8938;8350
4306957;RS;Entre Rios do Sul;3491;1556;1524;2130;950;3080;2724
4306973;RS;Erebango;3023;1490;1480;1958;1012;2970;2978
4307005;RS;Erechim;90347;46232;49873;90570;5535;96105;107368
4307054;RS;Ernestina;3941;1562;1526;1671;1417;3088;3171
4307104;RS;Herval;8487;3487;3270;4523;2234;6757;6807
4307203;RS;Erval Grande;5647;2624;2543;2690;2477;5167;4780
4307302;RS;Erval Seco;9177;3920;3958;3437;4441;7878;6697
4307401;RS;Esmeralda;5521;1573;1596;2128;1041;3169;3291
4307450;RS;Esperança do Sul;3755;1650;1622;844;2428;3272;2846
4307500;RS;Espumoso;16185;7530;7710;11131;4109;15240;15594
4307559;RS;Estação;6228;2951;3060;5119;892;6011;5924
4307609;RS;Estância Velha;35132;21045;21544;41496;1093;42589;51292
4307708;RS;Esteio;80048;38945;41724;80562;107;80669;83352
4307807;RS;Estrela;27401;15126;15502;25922;4706;30628;34669
4307815;RS;Estrela Velha;3691;1846;1782;1167;2461;3628;3646
4307831;RS;Eugênio de Castro;3313;1415;1382;1480;1317;2797;2310
4307864;RS;Fagundes Varela;2471;1300;1279;1293;1286;2579;2750
4307906;RS;Farroupilha;55308;31305;32336;55057;8584;63641;73758
4308003;RS;Faxinal do Soturno;6841;3274;3398;4175;2497;6672;6651
4308052;RS;Faxinalzinho;2923;1283;1284;1273;1294;2567;2256
4308078;RS;Fazenda Vilanova;2833;1856;1841;2013;1684;3697;4680
4308102;RS;Feliz;11316;6161;6198;9416;2943;12359;13728
4308201;RS;Flores da Cunha;23678;13556;13579;20862;6273;27135;31352
4308250;RS;Floriano Peixoto;2361;1081;937;292;1726;2018;1709
4308300;RS;Fontoura Xavier;11473;5458;5254;4093;6619;10712;10181
4308409;RS;Formigueiro;7598;3570;3444;2769;4245;7014;6569
4308433;RS;Forquetinha;0;1261;1212;465;2008;2473;2389
4308458;RS;Fortaleza dos Valos;5079;2241;2336;2993;1584;4577;4252
4308508;RS;Frederico Westphalen;26759;14132;14716;23338;5510;28848;31675
4308607;RS;Garibaldi;28337;15223;15469;27638;3054;30692;35794
4308656;RS;Garruchos;3675;1683;1550;1056;2177;3233;2851
4308706;RS;Gaurama;6391;2832;3030;3388;2474;5862;5447
4308805;RS;General Câmara;8737;4237;4215;4971;3481;8452;8339
4308854;RS;Gentil;1771;889;788;723;954;1677;1619
4308904;RS;Getúlio Vargas;16509;7850;8306;13864;2292;16156;16158
4309001;RS;Giruá;18749;8341;8744;12917;4168;17085;15729
4309050;RS;Glorinha;5684;3531;3354;2068;4817;6885;8304
4309100;RS;Gramado;28593;15685;16615;29039;3261;32300;36864
4309126;RS;Gramado dos Loureiros;2543;1151;1118;526;1743;2269;2036
4309159;RS;Gramado Xavier;3666;2044;1926;529;3441;3970;4378
4309209;RS;Gravataí;232629;124946;130816;243590;12172;255762;285564
4309258;RS;Guabiju;1749;806;792;738;860;1598;1478
4309308;RS;Guaíba;94307;46163;49067;93081;2149;95230;98331
4309407;RS;Guaporé;20064;11120;11690;20828;1982;22810;26199
4309506;RS;Guarani das Missões;8990;3951;4164;5030;3085;8115;7393
4309555;RS;Harmonia;3659;2150;2104;2456;1798;4254;4967
4309571;RS;Herveiras;2957;1543;1411;384;2570;2954;3019
4309605;RS;Horizontina;17699;8947;9403;14571;3779;18350;19446
4309654;RS;Hulha Negra;5359;3129;2919;2914;3134;6048;6894
4309704;RS;Humaitá;5228;2387;2532;2911;2008;4919;4712
4309753;RS;Ibarama;4454;2230;2141;1053;3318;4371;4393
4309803;RS;Ibiaçá;5233;2290;2420;2849;1861;4710;4690
4309902;RS;Ibiraiaras;7163;3589;3586;3815;3360;7175;7267
4309951;RS;Ibirapuitã;5170;2061;2000;2391;1670;4061;3988
4310009;RS;Ibirubá;18633;9472;9840;15344;3968;19312;20474
4310108;RS;Igrejinha;26767;15461;16202;30193;1470;31663;37754
4310207;RS;Ijuí;78461;38116;40804;71555;7365;78920;84041
4310306;RS;Ilópolis;4255;2055;2043;2203;1895;4098;4054
4310330;RS;Imbé;12242;8662;9005;17658;9;17667;23721
4310363;RS;Imigrante;3850;1496;1529;1501;1524;3025;3103
4310405;RS;Independência;7308;3293;3325;4157;2461;6618;6054
4310413;RS;Inhacorá;2378;1148;1119;1346;921;2267;2207
4310439;RS;Ipê;5456;3082;2935;2914;3103;6017;6736
4310462;RS;Ipiranga do Sul;2057;972;972;679;1265;1944;1871
4310504;RS;Iraí;9250;4075;4003;4457;3621;8078;7046
4310538;RS;Itaara;4578;2543;2468;3968;1043;5011;5573
4310553;RS;Itacurubi;3503;1778;1663;1184;2257;3441;3456
4310579;RS;Itapuca;2691;1229;1108;551;1786;2337;2037
4310603;RS;Itaqui;39770;19035;19131;33318;4848;38166;37363
4310652;RS;Itati;0;1343;1246;212;2377;2589;2377
4310702;RS;Itatiba do Sul;5252;2178;1993;1729;2442;4171;3143
4310751;RS;Ivorá;2495;1097;1059;705;1451;2156;1854
4310801;RS;Ivoti;15318;9800;10077;18065;1812;19877;25068
4310850;RS;Jaboticaba;4536;2087;2024;1487;2624;4111;3738
4310876;RS;Jacuizinho;0;1282;1225;562;1945;2507;2718
4310900;RS;Jacutinga;4248;1780;1850;2570;1060;3630;3532
4311007;RS;Jaguarão;30093;13600;14342;26101;1841;27942;26327
4311106;RS;Jaguari;12488;5737;5741;6531;4947;11478;10684
4311122;RS;Jaquirana;4814;2141;2036;2430;1747;4177;3611
4311130;RS;Jari;3751;1884;1691;613;2962;3575;3472
4311155;RS;Jóia;8284;4305;4024;2089;6240;8329;8571
4311205;RS;Júlio de Castilhos;20416;9626;9953;16106;3473;19579;19159
4311239;RS;Lagoa Bonita do Sul;0;1403;1259;384;2278;2662;2939
4311254;RS;Lagoão;6098;3194;2991;1655;4530;6185;6469
4311270;RS;Lagoa dos Três Cantos;1627;776;822;807;791;1598;1604
4311304;RS;Lagoa Vermelha;29833;13569;13960;24140;3389;27529;27751
4311403;RS;Lajeado;64133;34750;36731;71216;265;71481;86005
4311429;RS;Lajeado do Bugre;2463;1253;1234;706;1781;2487;2569
4311502;RS;Lavras do Sul;8109;3770;3899;4748;2921;7669;7410
4311601;RS;Liberato Salzano;6574;2948;2832;1297;4483;5780;5087
4311627;RS;Lindolfo Collor;4414;2680;2549;4289;940;5229;6193
4311643;RS;Linha Nova;1564;807;817;416;1208;1624;1724
4311700;RS;Machadinho;5728;2762;2753;3385;2130;5515;5411
4311718;RS;Maçambará;5035;2419;2323;1312;3430;4742;4539
4311734;RS;Mampituba;3106;1551;1446;568;2429;2997;2965
4311759;RS;Manoel Viana;6995;3558;3516;5364;1710;7074;7315
4311775;RS;Maquiné;7304;3525;3383;2067;4841;6908;6747
4311791;RS;Maratá;2513;1272;1255;753;1774;2527;2713
4311809;RS;Marau;28361;18034;18349;31577;4806;36383;45523
4311908;RS;Marcelino Ramos;6108;2555;2579;2722;2412;5134;4239
4311981;RS;Mariana Pimentel;3733;1970;1798;638;3130;3768;3892
4312005;RS;Mariano Moro;2474;1133;1077;1153;1057;2210;1987
4312054;RS;Marques de Souza;4241;2039;2029;1545;2523;4068;3981
4312104;RS;Mata;5575;2575;2536;2618;2493;5111;4760
4312138;RS;Mato Castelhano;2454;1292;1178;521;1949;2470;2543
4312153;RS;Mato Leitão;3210;1940;1929;1621;2248;3869;4627
4312179;RS;Mato Queimado;0;902;897;479;1320;1799;1611
4312203;RS;Maximiliano de Almeida;5651;2464;2443;2969;1938;4907;4254
4312252;RS;Minas do Leão;7321;3778;3853;7340;291;7631;8130
4312302;RS;Miraguaí;5034;2413;2442;2069;2786;4855;4899
4312351;RS;Montauri;1684;794;748;644;898;1542;1430
4312377;RS;Monte Alegre dos Campos;3040;1657;1441;645;2453;3098;3237
4312385;RS;Monte Belo do Sul;2880;1345;1325;770;1900;2670;2514
4312401;RS;Montenegro;54692;29248;30188;53645;5791;59436;66157
4312427;RS;Mormaço;2435;1395;1354;600;2149;2749;3139
4312443;RS;Morrinhos do Sul;3533;1617;1568;1300;1885;3185;2891
4312450;RS;Morro Redondo;5998;3137;3094;2648;3583;6231;6609
4312476;RS;Morro Reuter;4984;2851;2829;4845;835;5680;6570
4312500;RS;Mostardas;11658;6189;5941;8149;3981;12130;12888
4312609;RS;Muçum;4728;2300;2491;4044;747;4791;4967
4312617;RS;Muitos Capões;2867;1534;1443;964;2013;2977;3184
4312625;RS;Muliterno;1768;923;890;508;1305;1813;1901
4312658;RS;Não-Me-Toque;14413;7857;8081;13966;1972;15938;17886
4312674;RS;Nicolau Vergueiro;1812;862;859;636;1085;1721;1667
4312708;RS;Nonoai;12822;5932;6144;9067;3009;12076;11574
4312757;RS;Nova Alvorada;2757;1595;1582;1332;1845;3177;3698
4312807;RS;Nova Araçá;3236;1958;2045;2882;1121;4003;4890
4312906;RS;Nova Bassano;7836;4480;4360;5514;3326;8840;10089
4312955;RS;Nova Boa Vista;2222;981;979;578;1382;1960;1731
4313003;RS;Nova Bréscia;4564;1629;1555;1511;1673;3184;3345
4313011;RS;Nova Candelária;2883;1405;1346;709;2042;2751;2677
4313037;RS;Nova Esperança do Sul;4010;2306;2365;3599;1072;4671;5465
4313060;RS;Nova Hartz;15071;9072;9274;15269;3077;18346;22147
4313086;RS;Nova Pádua;2396;1256;1189;732;1713;2445;2563
4313102;RS;Nova Palma;6312;3219;3126;3083;3262;6345;6519
4313201;RS;Nova Petrópolis;16891;9375;9683;14146;4912;19058;21717
4313300;RS;Nova Prata;18344;11303;11527;18659;4171;22830;28021
4313334;RS;Nova Ramada;2723;1246;1191;670;1767;2437;2195
4313359;RS;Nova Roma do Sul;3032;1711;1636;1589;1758;3347;3743
4313375;RS;Nova Santa Rita;15750;11440;11266;19465;3241;22706;30482
4313391;RS;Novo Cabrais;3565;1946;1909;545;3310;3855;4246
4313409;RS;Novo Hamburgo;236193;115810;123241;234909;4142;239051;247303
4313425;RS;Novo Machado;4718;1949;1978;1553;2374;3927;3191
4313441;RS;Novo Tiradentes;2412;1191;1086;654;1623;2277;2189
4313466;RS;Novo Xingu;0;861;896;559;1198;1757;1705
4313490;RS;Novo Barreiro;3867;2032;1946;1306;2672;3978;4185
4313508;RS;Osório;36131;20186;20755;37951;2990;40941;46815
4313607;RS;Paim Filho;4831;2111;2132;2253;1990;4243;3731
4313656;RS;Palmares do Sul;10854;5462;5509;9805;1166;10971;11342
4313706;RS;Palmeira das Missões;38192;16643;17692;29836;4499;34335;32967
4313805;RS;Palmitinho;6943;3494;3426;3393;3527;6920;7056
4313904;RS;Panambi;32610;19018;19050;34572;3496;38068;44583
4313953;RS;Pantano Grande;10979;4909;4986;8314;1581;9895;8995
4314001;RS;Paraí;6020;3451;3361;3816;2996;6812;7793
4314027;RS;Paraíso do Sul;7212;3694;3642;2852;4484;7336;7635
4314035;RS;Pareci Novo;3242;1784;1727;981;2530;3511;3885
4314050;RS;Parobé;44776;25438;26043;48612;2869;51481;59419
4314068;RS;Passa Sete;4644;2681;2478;555;4604;5159;5790
4314076;RS;Passo do Sobrado;5566;2996;3015;1429;4582;6011;6612
4314100;RS;Passo Fundo;168458;88076;96793;180159;4710;184869;206103
4314134;RS;Paulo Bento;0;1126;1070;594;1602;2196;2303
4314159;RS;Paverama;7744;4052;3995;4101;3946;8047;8541
4314175;RS;Pedras Altas;0;1163;1055;772;1446;2218;1928
4314209;RS;Pedro Osório;8107;3834;3983;7309;508;7817;7683
4314308;RS;Pejuçara;4189;2008;1965;2672;1301;3973;3840
4314407;RS;Pelotas;323158;153898;173880;305696;22082;327778;343826
4314423;RS;Picada Café;4673;2594;2588;4559;623;5182;5780
4314456;RS;Pinhal;2503;1274;1241;1290;1225;2515;2581
4314464;RS;Pinhal da Serra;0;1109;1021;478;1652;2130;1896
4314472;RS;Pinhal Grande;4725;2314;2157;1895;2576;4471;4309
4314498;RS;Pinheirinho do Vale;4184;2280;2223;915;3588;4503;4926
4314506;RS;Pinheiro Machado;14594;6389;6398;9791;2996;12787;12122
4314548;RS;Pinto Bandeira;0;0;0;0;0;0;3068
4314555;RS;Pirapó;3349;1398;1359;777;1980;2757;2205
4314605;RS;Piratini;19414;10101;9730;11564;8267;19831;20743
4314704;RS;Planalto;11302;5209;5315;5932;4592;10524;9957
4314753;RS;Poço das Antas;1946;1023;994;861;1156;2017;2105
4314779;RS;Pontão;3904;1983;1874;1559;2298;3857;3898
4314787;RS;Ponte Preta;2153;924;826;512;1238;1750;1501
4314803;RS;Portão;24657;15490;15391;25233;5648;30881;38081
4314902;RS;Porto Alegre;1360590;654022;755917;1409939;0;1409939;1492530
4315008;RS;Porto Lucena;6398;2701;2720;2337;3084;5421;4514
4315057;RS;Porto Mauá;2802;1265;1279;956;1588;2544;2332
4315073;RS;Porto Vera Cruz;2464;936;916;440;1412;1852;1258
4315107;RS;Porto Xavier;11190;5301;5259;5210;5350;10560;10144
4315131;RS;Pouso Novo;2195;953;922;630;1245;1875;1586
4315149;RS;Presidente Lucena;2069;1312;1173;1511;974;2485;2972
4315156;RS;Progresso;6497;3176;2985;1871;4290;6161;6235
4315172;RS;Protásio Alves;2112;1079;921;427;1573;2000;1929
4315206;RS;Putinga;4629;2100;2047;1583;2564;4147;3861
4315305;RS;Quaraí;24002;11228;11793;21310;1711;23021;22531
4315313;RS;Quatro Irmãos;0;891;887;919;859;1778;1860
4315321;RS;Quevedos;2691;1447;1263;852;1858;2710;2793
4315354;RS;Quinze de Novembro;3582;1799;1854;1961;1692;3653;3810
4315404;RS;Redentora;8846;5210;5012;3002;7220;10222;11782
4315453;RS;Relvado;2294;1071;1084;734;1421;2155;2068
4315503;RS;Restinga Seca;16400;7815;8035;8982;6868;15850;15702
4315552;RS;Rio dos Índios;4702;1860;1756;755;2861;3616;2571
4315602;RS;Rio Grande;186544;94997;102256;189472;7781;197253;212881
4315701;RS;Rio Pardo;37783;18320;19282;25614;11988;37602;38257
4315750;RS;Riozinho;4071;2201;2126;2748;1579;4327;4698
4315800;RS;Roca Sales;9284;5089;5198;6602;3685;10287;11556
4315909;RS;Rodeio Bonito;5751;2846;2897;4310;1433;5743;5868
4315958;RS;Rolador;0;1318;1228;608;1938;2546;2270
4316006;RS;Rolante;17851;9771;9722;15318;4175;19493;21591
4316105;RS;Ronda Alta;10051;5008;5220;6875;3353;10228;10633
4316204;RS;Rondinha;6107;2722;2798;2317;3203;5520;5033
4316303;RS;Roque Gonzales;7799;3623;3583;3090;4116;7206;6750
4316402;RS;Rosário do Sul;41058;19342;20409;34938;4813;39751;39210
4316428;RS;Sagrada Família;2648;1339;1256;785;1810;2595;2601
4316436;RS;Saldanha Marinho;3195;1390;1479;1927;942;2869;2596
4316451;RS;Salto do Jacuí;12948;5878;6002;10208;1672;11880;12512
4316477;RS;Salvador das Missões;2665;1377;1292;1094;1575;2669;2734
4316501;RS;Salvador do Sul;6913;3412;3335;4009;2738;6747;7975
4316600;RS;Sananduva;14744;7604;7769;10697;4676;15373;16382
4316709;RS;Santa Bárbara do Sul;10003;4341;4488;6985;1844;8829;7813
4316733;RS;Santa Cecília do Sul;0;839;816;480;1175;1655;1630
4316758;RS;Santa Clara do Sul;4806;2845;2847;2849;2843;5692;6755
4316808;RS;Santa Cruz do Sul;107632;56892;61395;105184;13103;118287;132271
4316907;RS;Santa Maria;243611;123636;137391;248334;12693;261027;285159
4316956;RS;Santa Maria do Herval;5891;3101;2952;4362;1691;6053;6382
4316972;RS;Santa Margarida do Sul;0;1273;1079;552;1800;2352;2593
4317004;RS;Santana da Boa Vista;8621;4171;4073;3725;4519;8244;8037
4317103;RS;SantAna do Livramento;90849;39409;43104;74440;8073;82513;75647
4317202;RS;Santa Rosa;65016;33484;35111;60374;8221;68595;73882
4317251;RS;Santa Tereza;1768;887;830;624;1093;1717;1722
4317301;RS;Santa Vitória do Palmar;33304;15464;15538;26890;4112;31002;29298
4317400;RS;Santiago;52138;23578;25504;44746;4336;49082;49298
4317509;RS;Santo Ângelo;76745;36596;39708;71829;4475;76304;77544
4317558;RS;Santo Antônio do Palma;2207;1112;1027;681;1458;2139;2118
4317608;RS;Santo Antônio da Patrulha;37035;19752;19927;28105;11574;39679;43397
4317707;RS;Santo Antônio das Missões;12691;5579;5631;6788;4422;11210;9930
4317756;RS;Santo Antônio do Planalto;2001;979;1008;1233;754;1987;2018
4317806;RS;Santo Augusto;14426;6812;7158;11382;2588;13970;13813
4317905;RS;Santo Cristo;14890;7189;7189;7781;6597;14378;14177
4317954;RS;Santo Expedito do Sul;2683;1239;1222;872;1589;2461;2287
4318002;RS;São Borja;64869;30251;31411;55139;6523;61662;59768
4318051;RS;São Domingos do Sul;2831;1470;1456;1748;1178;2926;3091
4318101;RS;São Francisco de Assis;20810;9494;9764;13499;5759;19258;18081
4318200;RS;São Francisco de Paula;19725;10402;10138;13007;7533;20540;21871
4318309;RS;São Gabriel;62249;29474;31034;53860;6648;60508;62187
4318408;RS;São Jerônimo;20283;11029;11112;17062;5079;22141;24569
4318424;RS;São João da Urtiga;4929;2401;2325;2291;2435;4726;4625
4318432;RS;São João do Polêsine;2745;1272;1363;1354;1281;2635;2535
4318440;RS;São Jorge;2875;1379;1395;1451;1323;2774;2808
4318457;RS;São José das Missões;3000;1377;1343;828;1892;2720;2491
4318465;RS;São José do Herval;2530;1137;1067;867;1337;2204;1917
4318481;RS;São José do Hortêncio;3387;2088;2006;2645;1449;4094;4924
4318499;RS;São José do Inhacorá;2402;1125;1075;832;1368;2200;2040
4318507;RS;São José do Norte;23796;13011;12512;17403;8120;25523;27866
4318606;RS;São José do Ouro;7051;3382;3524;4425;2481;6906;6911
4318614;RS;São José do Sul;0;1052;1030;720;1362;2082;2464
4318622;RS;São José dos Ausentes;3104;1693;1597;2062;1228;3290;3559
4318705;RS;São Leopoldo;193547;104319;109891;213361;849;214210;240378
4318804;RS;São Lourenço do Sul;43691;21619;21495;24234;18880;43114;43501
4318903;RS;São Luiz Gonzaga;39553;16828;17730;30511;4047;34558;33124
4319000;RS;São Marcos;18958;9856;10249;17601;2504;20105;21756
4319109;RS;São Martinho;6321;2838;2935;3441;2332;5773;5336
4319125;RS;São Martinho da Serra;3246;1647;1554;942;2259;3201;3228
4319158;RS;São Miguel das Missões;7682;3880;3541;3727;3694;7421;7692
4319208;RS;São Nicolau;6406;2906;2821;3692;2035;5727;5153
4319307;RS;São Paulo das Missões;7187;3230;3137;2199;4168;6367;5654
4319356;RS;São Pedro da Serra;2843;1684;1633;1431;1886;3317;3881
4319364;RS;São Pedro das Missões;0;932;954;532;1354;1886;2025
4319372;RS;São Pedro do Butiá;2862;1456;1417;1209;1664;2873;2950
4319406;RS;São Pedro do Sul;16989;8052;8319;11932;4439;16371;16100
4319505;RS;São Sebastião do Caí;19700;10744;11200;17611;4333;21944;26161
4319604;RS;São Sepé;24621;11776;12022;18821;4977;23798;23492
4319703;RS;São Valentim;4109;1811;1821;1744;1888;3632;3220
4319711;RS;São Valentim do Sul;2140;1112;1056;746;1422;2168;2248
4319737;RS;São Valério do Sul;2625;1375;1272;510;2137;2647;2732
4319752;RS;São Vendelino;1682;994;950;1353;591;1944;2288
4319802;RS;São Vicente do Sul;8336;4205;4235;5881;2559;8440;8742
4319901;RS;Sapiranga;69189;37012;38008;72323;2697;75020;80514
4320008;RS;Sapucaia do Sul;122751;63756;67232;130500;488;130988;142508
4320107;RS;Sarandi;18162;10272;11040;17957;3355;21312;25024
4320206;RS;Seberi;11349;5352;5550;5923;4979;10902;10678
4320230;RS;Sede Nova;3208;1531;1480;1581;1430;3011;2875
4320263;RS;Segredo;6911;3696;3462;1807;5351;7158;7465
4320305;RS;Selbach;4861;2403;2526;3450;1479;4929;5114
4320321;RS;Senador Salgado Filho;2927;1407;1407;880;1934;2814;2761
4320354;RS;Sentinela do Sul;4892;2666;2531;1279;3918;5197;5635
4320404;RS;Serafina Corrêa;10894;7098;7145;12054;2189;14243;18074
4320453;RS;Sério;2706;1190;1091;530;1751;2281;1889
4320503;RS;Sertão;7466;3045;3249;3387;2907;6294;5220
4320552;RS;Sertão Santana;5272;2934;2916;1278;4572;5850;6586
4320578;RS;Sete de Setembro;2357;1081;1045;494;1632;2126;1931
4320602;RS;Severiano de Almeida;4153;1942;1900;1399;2443;3842;3607
4320651;RS;Silveira Martins;2571;1229;1223;1091;1361;2452;2365
4320677;RS;Sinimbu;10210;5216;4851;1437;8630;10067;10152
4320701;RS;Sobradinho;16328;6992;7293;11349;2936;14285;15041
4320800;RS;Soledade;29727;14723;15342;24040;6025;30065;31067
4320859;RS;Tabaí;3563;2102;2029;1246;2885;4131;4816
4320909;RS;Tapejara;15115;9396;9856;17082;2170;19252;24973
4321006;RS;Tapera;10564;5095;5357;8824;1628;10452;10569
4321105;RS;Tapes;16291;8181;8468;14494;2155;16649;17363
4321204;RS;Taquara;52825;26875;27781;45276;9380;54656;57740
4321303;RS;Taquari;25887;12705;13430;21920;4215;26135;26907
4321329;RS;Taquaruçu do Sul;2921;1519;1451;1164;1806;2970;3081
4321352;RS;Tavares;5342;2777;2574;3299;2052;5351;5484
4321402;RS;Tenente Portela;14343;6711;7005;8847;4869;13716;13385
4321436;RS;Terra de Areia;11453;4960;4918;5195;4683;9878;11323
4321451;RS;Teutônia;22891;13516;13749;23317;3948;27265;34275
4321469;RS;Tio Hugo;0;1372;1352;1164;1560;2724;3078
4321477;RS;Tiradentes do Sul;7497;3268;3193;2098;4363;6461;5532
4321493;RS;Toropi;3196;1561;1391;611;2341;2952;2753
4321501;RS;Torres;30880;16841;17805;33329;1317;34646;39381
4321600;RS;Tramandaí;31040;20169;21486;40652;1003;41655;53507
4321626;RS;Travesseiro;2349;1171;1143;887;1427;2314;2331
4321634;RS;Três Arroios;3144;1428;1427;1027;1828;2855;2620
4321667;RS;Três Cachoeiras;9523;5172;5067;7523;2716;10239;11174
4321709;RS;Três Coroas;19430;11843;12012;20553;3302;23855;28948
4321808;RS;Três de Maio;24136;11484;12242;18962;4764;23726;23846
4321832;RS;Três Forquilhas;3239;1510;1402;385;2527;2912;2643
4321857;RS;Três Palmeiras;4620;2210;2171;2090;2291;4381;4232
4321907;RS;Três Passos;24656;11753;12220;19060;4913;23973;23799
4321956;RS;Trindade do Sul;5922;2884;2903;2899;2888;5787;5781
4322004;RS;Triunfo;22166;12953;12858;16882;8929;25811;30159
4322103;RS;Tucunduva;6305;2818;3083;4038;1863;5901;5612
4322152;RS;Tunas;4310;2278;2117;1375;3020;4395;4585
4322186;RS;Tupanci do Sul;1728;815;759;473;1101;1574;1447
4322202;RS;Tupanciretã;20947;10867;11419;18025;4261;22286;24182
4322251;RS;Tupandi;2958;2063;1856;2716;1203;3919;5019
4322301;RS;Tuparendi;9542;4146;4411;5294;3263;8557;7730
4322327;RS;Turuçu;3710;1778;1744;1487;2035;3522;3408
4322343;RS;Ubiretama;2677;1183;1113;500;1796;2296;1952
4322350;RS;União da Serra;1908;797;690;280;1207;1487;1084
4322376;RS;Unistalda;2644;1247;1206;913;1540;2453;2306
4322400;RS;Uruguaiana;126936;61057;64450;117461;8046;125507;126766
4322509;RS;Vacaria;57341;30089;31256;57337;4008;61345;66916
4322525;RS;Vale Verde;3057;1652;1601;882;2371;3253;3531
4322533;RS;Vale do Sol;10558;5597;5480;1249;9828;11077;11873
4322541;RS;Vale Real;4340;2576;2545;4569;552;5121;6046
4322558;RS;Vanini;1887;993;991;1001;983;1984;2130
4322608;RS;Venâncio Aires;61234;32648;33316;41416;24548;65964;72373
4322707;RS;Vera Cruz;21300;11751;12235;13320;10666;23986;27325
4322806;RS;Veranópolis;19466;11101;11714;19847;2968;22815;26813
4322855;RS;Vespasiano Correa;2209;1024;950;406;1568;1974;1776
4322905;RS;Viadutos;6087;2620;2691;2643;2668;5311;4628
4323002;RS;Viamão;227429;116344;122890;224962;14272;239234;257330
4323101;RS;Vicente Dutra;6128;2701;2584;2351;2934;5285;4530
4323200;RS;Victor Graeff;3924;1512;1524;1284;1752;3036;2840
4323309;RS;Vila Flores;3086;1617;1590;1348;1859;3207;3407
4323358;RS;Vila Lângaro;2277;1123;1029;366;1786;2152;2070
4323408;RS;Vila Maria;4173;2116;2105;2249;1972;4221;4368
4323457;RS;Vila Nova do Sul;4263;2102;2119;2194;2027;4221;4274
4323507;RS;Vista Alegre;2996;1400;1432;1185;1647;2832;2726
4323606;RS;Vista Alegre do Prata;1618;819;750;463;1106;1569;1553
4323705;RS;Vista Gaúcha;2725;1395;1364;965;1794;2759;2858
4323754;RS;Vitória das Missões;3979;1794;1691;669;2816;3485;3052
4323770;RS;Westfalia;0;1406;1387;1130;1663;2793;3046
4323804;RS;Xangri-lá;8197;6190;6215;12350;55;12405;17126
5000203;MS;Água Clara;11015;7552;6877;9598;4831;14429;16025
5000252;MS;Alcinópolis;3679;2433;2137;3138;1432;4570;5489
5000609;MS;Amambai;29484;17379;17360;22383;12356;34739;40247
5000708;MS;Anastácio;22477;11915;11931;19681;4165;23846;25336
5000807;MS;Anaurilândia;7955;4308;4186;4322;4172;8494;9116
5000856;MS;Angélica;7356;4707;4463;7680;1490;9170;11081
5000906;MS;Antônio João;7408;4111;4104;6836;1379;8215;9082
5001003;MS;Aparecida do Taboado;18402;11152;11153;20094;2211;22305;26386
5001102;MS;Aquidauana;43440;22855;22768;35954;9669;45623;48184
5001243;MS;Aral Moreira;8055;5269;4986;5361;4894;10255;12511
5001508;MS;Bandeirantes;6425;3455;3143;4520;2078;6598;7281
5001904;MS;Bataguassu;16197;10089;9736;15234;4591;19825;23620
5002001;MS;Batayporã;10625;5405;5533;8331;2607;10938;11368
5002100;MS;Bela Vista;21764;11720;11455;18924;4251;23175;24842
5002159;MS;Bodoquena;8367;4112;3874;5778;2208;7986;7802
5002209;MS;Bonito;16956;9890;9708;16161;3437;19598;22401
5002308;MS;Brasilândia;11956;6040;5764;8005;3799;11804;11835
5002407;MS;Caarapó;20706;12913;12850;18305;7458;25763;31005
5002605;MS;Camapuã;16446;7071;6577;9822;3826;13648;13675
5002704;MS;Campo Grande;663621;381544;405660;776654;10550;787204;916001
5002803;MS;Caracol;4592;2766;2634;3240;2160;5400;6247
5002902;MS;Cassilândia;20087;10434;10498;18970;1962;20932;22063
5002951;MS;Chapadão do Sul;11658;10291;9363;16805;2849;19654;26499
5003108;MS;Corguinho;3592;2629;2233;1872;2990;4862;6158
5003157;MS;Coronel Sapucaia;12810;6954;7110;10208;3856;14064;15449
5003207;MS;Corumbá;95701;52304;51468;93510;10262;103772;112669
5003256;MS;Costa Rica;15488;10239;9450;16840;2849;19689;21456
5003306;MS;Coxim;30866;16150;16030;29160;3020;32180;33547
5003454;MS;Deodápolis;11350;6126;6005;10042;2089;12131;13043
5003488;MS;Dois Irmãos do Buriti;9335;5531;4831;4706;5656;10362;11547
5003504;MS;Douradina;4732;2722;2643;3286;2079;5365;6025
5003702;MS;Dourados;164949;96342;99726;181086;14982;196068;227990
5003751;MS;Eldorado;11059;5789;5891;9333;2347;11680;12447
5003801;MS;Fátima do Sul;19111;9360;9664;16956;2068;19024;19152
5003900;MS;Figueirão;0;1550;1377;1530;1397;2927;3066
5004007;MS;Glória de Dourados;10035;4895;5033;7671;2257;9928;9934
5004106;MS;Guia Lopes da Laguna;11115;5209;5159;8787;1581;10368;9754
5004304;MS;Iguatemi;13617;7430;7457;11020;3867;14887;16273
5004403;MS;Inocência;7872;3975;3711;4888;2798;7686;7566
5004502;MS;Itaporã;17045;10411;10468;13302;7577;20879;25478
5004601;MS;Itaquiraí;15770;9706;8912;7603;11015;18618;21604
5004700;MS;Ivinhema;21643;11272;11083;17284;5071;22355;23277
5004809;MS;Japorã;6140;3869;3776;1410;6235;7645;9372
5004908;MS;Jaraguari;5389;3405;2936;1786;4555;6341;7342
5005004;MS;Jardim;22542;12134;12229;22758;1605;24363;26375
5005103;MS;Jateí;4054;2094;1923;1871;2146;4017;4015
5005152;MS;Juti;4981;3010;2890;3925;1975;5900;6861
5005202;MS;Ladário;15313;9852;9801;18601;1052;19653;24040
5005251;MS;Laguna Carapã;5531;3295;3198;2739;3754;6493;7496
5005400;MS;Maracaju;26219;19389;18018;32225;5182;37407;48944
5005608;MS;Miranda;23007;13230;12385;15586;10029;25615;28423
5005681;MS;Mundo Novo;15669;8261;8774;15273;1762;17035;18578
5005707;MS;Naviraí;36662;23203;23152;42782;3573;46355;56484
5005806;MS;Nioaque;15086;7547;6849;7059;7337;14396;13794
5006002;MS;Nova Alvorada do Sul;9956;8480;7953;12297;4136;16433;22967
5006200;MS;Nova Andradina;35381;22748;22851;38793;6806;45599;56057
5006259;MS;Novo Horizonte do Sul;6415;2518;2426;2667;2277;4944;3556
5006275;MS;Paraíso das Águas;0;0;0;0;0;0;5751
5006309;MS;Paranaíba;38406;19965;20209;35731;4443;40174;42401
5006358;MS;Paranhos;10215;6263;6092;6263;6092;12355;14576
5006408;MS;Pedro Gomes;8535;4149;3818;6148;1819;7967;7568
5006606;MS;Ponta Porã;60916;38480;39386;62054;15812;77866;95320
5006903;MS;Porto Murtinho;13316;8232;7137;10059;5310;15369;17460
5007109;MS;Ribas do Rio Pardo;16721;10989;9978;12973;7994;20967;25310
5007208;MS;Rio Brilhante;22640;15699;14948;24540;6107;30647;38844
5007307;MS;Rio Negro;5432;2606;2434;3669;1371;5040;4758
5007406;MS;Rio Verde de Mato Grosso;18138;9486;9406;16296;2596;18892;20025
5007505;MS;Rochedo;4358;2570;2352;2884;2038;4922;5120
5007554;MS;Santa Rita do Pardo;6640;3805;3449;3534;3720;7254;7948
5007695;MS;São Gabriel do Oeste;16821;11173;10991;19274;2890;22164;27660
5007703;MS;Sete Quedas;10936;5484;5296;8974;1806;10780;10751
5007802;MS;Selvíria;6085;3209;3068;4771;1506;6277;6555
5007901;MS;Sidrolândia;23483;21508;20568;27723;14353;42076;60792
5007935;MS;Sonora;9543;7865;7002;13434;1433;14867;20158
5007950;MS;Tacuru;8717;5274;4941;3767;6448;10215;11795
5007976;MS;Taquarussu;3493;1805;1707;2448;1064;3512;3588
5008008;MS;Terenos;11662;9146;8016;7284;9878;17162;22721
5008305;MS;Três Lagoas;79059;50468;51254;96995;4727;101722;125137
5008404;MS;Vicentina;5779;2959;2942;4243;1658;5901;6115
5100102;MT;Acorizal;5817;2900;2616;2927;2589;5516;5309
5100201;MT;Água Boa;16737;10915;9929;16725;4119;20844;26679
5100250;MT;Alta Floresta;46982;25022;24211;42787;6446;49233;52105
5100300;MT;Alto Araguaia;11410;8069;7601;13856;1814;15670;19714
5100359;MT;Alto Boa Vista;6206;2731;2518;3180;2069;5249;7092
5100409;MT;Alto Garças;8335;5402;4919;9425;896;10321;12323
5100508;MT;Alto Paraguai;8605;5302;4649;6411;3540;9951;11587
5100607;MT;Alto Taquari;4476;4284;3816;7346;754;8100;11413
5100805;MT;Apiacás;6665;4633;3905;6357;2181;8538;10431
5101001;MT;Araguaiana;3426;1648;1573;2190;1031;3221;3064
5101209;MT;Araguainha;1352;585;510;944;151;1095;909
5101258;MT;Araputanga;13675;7610;7777;12206;3181;15387;17078
5101308;MT;Arenápolis;11605;5218;5137;9784;571;10355;9399
5101407;MT;Aripuanã;27560;10032;8549;11674;6907;18581;23067
5101605;MT;Barão de Melgaço;7682;4134;3457;3422;4169;7591;8165
5101704;MT;Barra do Bugres;27460;16134;14924;25912;5146;31058;35642
5101803;MT;Barra do Garças;52092;28123;28300;50930;5493;56423;61702
5101852;MT;Bom Jesus do Araguaia;0;2806;2425;2632;2599;5231;6830
5101902;MT;Brasnorte;9815;8244;7036;9990;5290;15280;20571
5102504;MT;Cáceres;85857;44040;43872;76558;11354;87912;95339
5102603;MT;Campinápolis;12419;7365;6857;4816;9406;14222;16223
5102637;MT;Campo Novo do Parecis;17638;14483;13091;25581;1993;27574;36917
5102678;MT;Campo Verde;17221;16293;15319;25512;6100;31612;44033
5102686;MT;Campos de Júlio;2895;2589;2430;3991;1028;5019;7245
5102694;MT;Canabrava do Norte;4989;2542;2225;2673;2094;4767;4711
5102702;MT;Canarana;15408;9636;9065;14813;3888;18701;22101
5102793;MT;Carlinda;12296;5818;5167;4569;6416;10985;10094
5102850;MT;Castanheira;7790;4346;3885;3921;4310;8231;8782
5103007;MT;Chapada dos Guimarães;15755;9293;8506;10988;6811;17799;22521
5103056;MT;Cláudia;10249;5692;5280;8457;2515;10972;12338
5103106;MT;Cocalinho;5504;2901;2597;3647;1851;5498;5716
5103205;MT;Colíder;28051;15624;15240;25065;5799;30864;33855
5103254;MT;Colniza;0;14085;12305;15011;11379;26390;41117
5103304;MT;Comodoro;15046;9365;8792;12568;5589;18157;21249
5103353;MT;Confresa;17841;13345;11782;16224;8903;25127;32076
5103361;MT;Conquista DOeste;0;1789;1599;2053;1335;3388;4163
5103379;MT;Cotriguaçu;8474;7979;7008;5132;9855;14987;20717
5103403;MT;Cuiabá;483346;269397;281953;541002;10348;551350;623614
5103437;MT;Curvelândia;0;2550;2348;2914;1984;4898;5267
5103452;MT;Denise;7463;4382;4112;7259;1235;8494;9626
5103502;MT;Diamantino;18580;10549;9871;15920;4500;20420;22311
5103601;MT;Dom Aquino;8418;4194;3937;6542;1589;8131;8087
5103700;MT;Feliz Natal;6769;5580;5353;8123;2810;10933;14847
5103809;MT;Figueirópolis DOeste;4315;1943;1862;2014;1791;3805;3411
5103858;MT;Gaúcha do Norte;4605;3435;2852;2199;4088;6287;7913
5103908;MT;General Carneiro;4349;2638;2380;2356;2662;5018;5726
5103957;MT;Glória DOeste;3361;1581;1544;2129;996;3125;2990
5104104;MT;Guarantã do Norte;28200;16479;15671;23917;8233;32150;36439
5104203;MT;Guiratinga;12645;7237;6630;11434;2433;13867;15740
5104500;MT;Indiavaí;2056;1248;1159;1778;629;2407;2806
5104526;MT;Ipiranga do Norte;0;2795;2328;3475;1648;5123;8182
5104542;MT;Itanhangá;0;2869;2391;3165;2095;5260;7030
5104559;MT;Itaúba;8565;2394;2176;3710;860;4570;3609
5104609;MT;Itiquira;9200;6234;5259;4447;7046;11493;13727
5104807;MT;Jaciara;23796;12993;12673;23642;2024;25666;27696
5104906;MT;Jangada;7134;3963;3733;2946;4750;7696;8420
5105002;MT;Jauru;12764;5265;5196;6171;4290;10461;8377
5105101;MT;Juara;30748;16948;15821;26031;6738;32769;35275
5105150;MT;Juína;38017;20133;19127;33969;5291;39260;41190
5105176;MT;Juruena;5448;5849;5420;6801;4468;11269;16811
5105200;MT;Juscimeira;12063;5959;5475;8500;2934;11434;11124
5105234;MT;Lambari DOeste;4690;2856;2582;2898;2540;5438;6246
5105259;MT;Lucas do Rio Verde;19316;24005;21540;42438;3107;45545;69671
5105309;MT;Luciara;2494;1150;1079;2034;195;2229;2036
5105507;MT;Vila Bela da Santíssima Trindade;12665;7559;6932;5175;9316;14491;16412
5105580;MT;Marcelândia;14448;6354;5640;7418;4576;11994;10107
5105606;MT;Matupá;11289;7355;6817;10929;3243;14172;17017
5105622;MT;Mirassol DOeste;22997;12699;12632;21465;3866;25331;28135
5105903;MT;Nobres;14983;7834;7177;12461;2550;15011;15332
5106000;MT;Nortelândia;7246;3309;3129;5276;1162;6438;5858
5106109;MT;Nossa Senhora do Livramento;12141;6256;5336;4247;7345;11592;13093
5106158;MT;Nova Bandeirantes;6951;6373;5257;4060;7570;11630;16052
5106174;MT;Nova Nazaré;0;1553;1468;1112;1909;3021;4013
5106182;MT;Nova Lacerda;4045;2934;2535;2996;2473;5469;6861
5106190;MT;Nova Santa Helena;0;1818;1657;2000;1475;3475;3755
5106208;MT;Nova Brasilândia;5786;2403;2190;3663;930;4593;3656
5106216;MT;Nova Canaã do Norte;11516;6452;5680;6817;5315;12132;12876
5106224;MT;Nova Mutum;14818;16798;14835;25858;5775;31633;48222
5106232;MT;Nova Olímpia;14186;9064;8465;15843;1686;17529;20820
5106240;MT;Nova Ubiratã;5654;5153;4092;5935;3310;9245;12492
5106257;MT;Nova Xavantina;17832;9936;9539;15731;3744;19475;21695
5106265;MT;Novo Mundo;4997;3802;3267;2636;4433;7069;9545
5106273;MT;Novo Horizonte do Norte;3511;1934;1812;1777;1969;3746;4069
5106281;MT;Novo São Joaquim;9464;3144;2899;3717;2326;6043;4837
5106299;MT;Paranaíta;10254;5745;4945;5654;5036;10690;11291
5106307;MT;Paranatinga;15342;10305;8975;14812;4468;19280;23250
5106315;MT;Novo Santo Antônio;0;1105;900;1346;659;2005;2769
5106372;MT;Pedra Preta;13611;8111;7582;11381;4312;15693;17547
5106422;MT;Peixoto de Azevedo;26156;15925;14837;19799;10963;30762;35695
5106455;MT;Planalto da Serra;2881;1400;1326;2054;672;2726;2637
5106505;MT;Poconé;30773;16521;15257;23062;8716;31778;33386
5106653;MT;Pontal do Araguaia;3736;2796;2631;4484;943;5427;6972
5106703;MT;Ponte Branca;2087;922;861;1516;267;1783;1525
5106752;MT;Pontes e Lacerda;43012;20914;20472;34629;6757;41386;46105
5106778;MT;Porto Alegre do Norte;8623;5739;5015;5179;5575;10754;12849
5106802;MT;Porto dos Gaúchos;5665;2858;2590;2767;2681;5448;5344
5106828;MT;Porto Esperidião;9996;5859;5091;4172;6778;10950;12176
5106851;MT;Porto Estrela;4707;1900;1739;1466;2173;3639;2794
5107008;MT;Poxoréo;20030;9254;8348;11924;5678;17602;15936
5107040;MT;Primavera do Leste;39857;26522;25592;49308;2806;52114;63876
5107065;MT;Querência;7274;6922;6099;5972;7049;13021;18386
5107107;MT;São José dos Quatro Marcos;19693;9488;9475;14506;4457;18963;18788
5107156;MT;Reserva do Cabaçal;2418;1326;1252;1622;956;2578;2754
5107180;MT;Ribeirão Cascalheira;8866;4607;4273;5560;3320;8880;10450
5107198;MT;Ribeirãozinho;1980;1126;1073;1554;645;2199;2439
5107206;MT;Rio Branco;5092;2537;2524;4144;917;5061;5147
5107248;MT;Santa Carmem;3599;2132;1943;3071;1004;4075;4600
5107263;MT;Santo Afonso;3098;1610;1364;1538;1436;2974;3164
5107297;MT;São José do Povo;3056;1934;1667;1758;1843;3601;4102
5107305;MT;São José do Rio Claro;12740;9173;7955;13170;3958;17128;21351
5107354;MT;São José do Xingu;5944;2827;2440;3791;1476;5267;5646
5107404;MT;São Pedro da Cipa;3495;2143;1999;3694;448;4142;4823
5107578;MT;Rondolândia;0;1860;1678;950;2588;3538;4069
5107602;MT;Rondonópolis;150227;98217;97333;188119;7431;195550;239613
5107701;MT;Rosário Oeste;18755;9419;8263;10656;7026;17682;16999
5107743;MT;Santa Cruz do Xingu;0;1046;853;1251;648;1899;2700
5107750;MT;Salto do Céu;4675;2014;1889;2185;1718;3903;3226
5107768;MT;Santa Rita do Trivelato;0;1352;1114;1365;1101;2466;3602
5107776;MT;Santa Terezinha;6270;3936;3463;2976;4423;7399;8547
5107792;MT;Santo Antônio do Leste;0;2029;1728;2119;1638;3757;5459
5107800;MT;Santo Antônio do Leverger;15435;9843;8566;7148;11261;18409;17188
5107859;MT;São Félix do Araguaia;10687;5510;5021;6164;4367;10531;11934
5107875;MT;Sapezal;7866;9777;8303;15120;2960;18080;27485
5107883;MT;Serra Nova Dourada;0;743;622;813;552;1365;1705
5107909;MT;Sinop;74831;57561;55521;93735;19347;113082;148960
5107925;MT;Sorriso;35605;34282;32224;58363;8143;66506;94941
5107941;MT;Tabaporã;10842;5290;4627;5279;4638;9917;9357
5107958;MT;Tangará da Serra;58840;42335;41741;75883;8193;84076;107631
5108006;MT;Tapurah;11561;6057;4333;6526;3864;10390;14380
5108055;MT;Terra Nova do Norte;13694;5885;5417;5060;6242;11302;9284
5108105;MT;Tesouro;3130;1908;1529;2398;1039;3437;3761
5108204;MT;Torixoréu;4832;2098;1938;3117;919;4036;3487
5108303;MT;União do Sul;4196;2049;1718;2339;1428;3767;3455
5108352;MT;Vale de São Domingos;0;1646;1412;713;2345;3058;3124
5108402;MT;Várzea Grande;215298;125358;127351;248829;3880;252709;290383
5108501;MT;Vera;9055;5304;4931;7349;2886;10235;11731
5108600;MT;Vila Rica;15583;11203;10200;13977;7426;21403;26946
5108808;MT;Nova Guarita;5651;2581;2348;1937;2992;4929;4407
5108857;MT;Nova Marilândia;2354;1575;1350;1933;992;2925;3332
5108907;MT;Nova Maringá;3950;3599;2991;3421;3169;6590;9056
5108956;MT;Nova Monte Verde;6827;4383;3705;3973;4115;8088;9375
5200050;GO;Abadia de Goiás;4971;3376;3492;5072;1796;6868;9158
5200100;GO;Abadiânia;11452;8088;7664;10773;4979;15752;20873
5200134;GO;Acreúna;18301;10380;9903;17700;2583;20283;22710
5200159;GO;Adelândia;2460;1277;1206;2204;279;2483;2515
5200175;GO;Água Fria de Goiás;4469;2738;2357;2137;2958;5095;5843
5200209;GO;Água Limpa;2200;1048;964;1425;587;2012;1809
5200258;GO;Águas Lindas de Goiás;105746;79813;79692;159265;240;159505;222850
5200308;GO;Alexânia;20047;12012;11816;19701;4127;23828;28360
5200506;GO;Aloândia;2128;1045;999;1764;280;2044;1976
5200555;GO;Alto Horizonte;2564;2351;2154;3863;642;4505;6796
5200605;GO;Alto Paraíso de Goiás;6182;3400;3464;5202;1662;6864;7751
5200803;GO;Alvorada do Norte;7560;4113;3980;6882;1211;8093;8749
5200829;GO;Amaralina;3074;1828;1596;1093;2331;3424;3875
5200852;GO;Americano do Brasil;4933;2858;2650;4718;790;5508;6220
5200902;GO;Amorinópolis;4145;1829;1778;2169;1438;3607;3011
5201108;GO;Anápolis;288085;163467;171565;329170;5862;335032;396526
5201207;GO;Anhanguera;895;514;503;955;62;1017;1171
5201306;GO;Anicuns;18754;10429;9843;17332;2940;20272;22113
5201405;GO;Aparecida de Goiânia;336392;224841;230894;455264;471;455735;601844
5201454;GO;Aparecida do Rio Doce;2402;1243;1190;1954;479;2433;2474
5201504;GO;Aporé;3427;2010;1801;2546;1265;3811;4266
5201603;GO;Araçu;4127;1902;1883;3340;445;3785;3450
5201702;GO;Aragarças;16592;9193;9117;17625;685;18310;20410
5201801;GO;Aragoiânia;6424;4275;4100;5529;2846;8375;10680
5202155;GO;Araguapaz;7310;3860;3653;5204;2309;7513;7795
5202353;GO;Arenópolis;3999;1676;1602;1919;1359;3278;2462
5202502;GO;Aruanã;5095;3925;3581;6182;1324;7506;10340
5202601;GO;Aurilândia;4235;1839;1811;2800;850;3650;3000
5202809;GO;Avelinópolis;2507;1236;1215;1876;575;2451;2401
5203104;GO;Baliza;2270;2043;1671;1094;2620;3714;5418
5203203;GO;Barro Alto;6251;4500;4201;6249;2452;8701;11643
5203302;GO;Bela Vista de Goiás;19210;12602;11937;17945;6594;24539;31004
5203401;GO;Bom Jardim de Goiás;8068;4304;4119;6349;2074;8423;8912
5203500;GO;Bom Jesus de Goiás;16257;10757;9972;19255;1474;20729;26069
5203559;GO;Bonfinópolis;5353;3777;3759;7021;515;7536;10120
5203575;GO;Bonópolis;2598;1834;1669;1301;2202;3503;4579
5203609;GO;Brazabrantes;2772;1649;1591;2179;1061;3240;3812
5203807;GO;Britânia;5279;2809;2700;4543;966;5509;5815
5203906;GO;Buriti Alegre;8718;4535;4521;8414;642;9056;9515
5203939;GO;Buriti de Goiás;2659;1323;1238;1734;827;2561;2464
5203962;GO;Buritinópolis;3383;1701;1618;1883;1436;3319;3272
5204003;GO;Cabeceiras;6758;3775;3571;5497;1849;7346;8098
5204102;GO;Cachoeira Alta;8646;5734;4805;8382;2157;10539;12843
5204201;GO;Cachoeira de Goiás;1498;731;686;1171;246;1417;1336
5204250;GO;Cachoeira Dourada;8525;4184;4083;5368;2899;8267;7997
5204300;GO;Caçu;10575;7029;6250;10739;2540;13279;16525
5204409;GO;Caiapônia;14673;8500;8234;12257;4477;16734;19304
5204508;GO;Caldas Novas;49660;34995;35468;67693;2770;70463;95183
5204557;GO;Caldazinha;2859;1691;1631;1918;1404;3322;3900
5204607;GO;Campestre de Goiás;3167;1772;1615;2376;1011;3387;3662
5204656;GO;Campinaçu;3707;1933;1721;2175;1479;3654;3628
5204706;GO;Campinorte;9641;5703;5412;8999;2116;11115;12880
5204805;GO;Campo Alegre de Goiás;4528;3095;2962;4494;1563;6057;7884
5204854;GO;Campo Limpo de Goiás;0;3185;3085;5309;961;6270;8087
5204904;GO;Campos Belos;17047;9133;9262;16184;2211;18395;20124
5204953;GO;Campos Verdes;8057;2572;2450;4478;544;5022;1526
5205000;GO;Carmo do Rio Verde;7941;4547;4392;7065;1874;8939;10299
5205059;GO;Castelândia;3882;1918;1720;3344;294;3638;3380
5205109;GO;Catalão;64347;43470;43127;81020;5577;86597;113091
5205208;GO;Caturaí;4330;2390;2280;3655;1015;4670;5132
5205307;GO;Cavalcante;9150;4915;4479;4747;4647;9394;9740
5205406;GO;Ceres;22209;10119;10567;19753;933;20686;22407
5205455;GO;Cezarina;6514;3873;3675;5598;1950;7548;8794
5205471;GO;Chapadão do Céu;3778;3660;3344;5879;1125;7004;10797
5205497;GO;Cidade Ocidental;40377;27416;28467;43613;12270;55883;74370
5205513;GO;Cocalzinho de Goiás;14626;8937;8454;6448;10943;17391;20771
5205521;GO;Colinas do Sul;3702;1838;1685;2525;998;3523;3339
5205703;GO;Córrego do Ouro;2973;1337;1292;1632;997;2629;2254
5205802;GO;Corumbá de Goiás;9679;5402;4942;6416;3928;10344;11223
5205901;GO;Corumbaíba;6655;4275;3889;6303;1861;8164;10012
5206206;GO;Cristalina;34116;23993;22575;38430;8138;46568;61385
5206305;GO;Cristianópolis;2924;1498;1435;2472;461;2933;2962
5206404;GO;Crixás;14673;8252;7510;12325;3437;15762;17136
5206503;GO;Cromínia;3660;1794;1761;2675;880;3555;3458
5206602;GO;Cumari;3105;1512;1449;2419;542;2961;2820
5206701;GO;Damianópolis;3303;1712;1585;1857;1440;3297;3302
5206800;GO;Damolândia;2573;1383;1364;2182;565;2747;2944
5206909;GO;Davinópolis;2109;1077;973;1398;652;2050;2094
5207105;GO;Diorama;2498;1262;1217;1506;973;2479;2477
5207253;GO;Doverlândia;8558;4162;3730;4916;2976;7892;7174
5207352;GO;Edealina;3803;1930;1803;2569;1164;3733;3678
5207402;GO;Edéia;10223;5778;5488;9538;1728;11266;12559
5207501;GO;Estrela do Norte;3398;1722;1596;2929;389;3318;3253
5207535;GO;Faina;7419;3652;3328;3850;3130;6980;6527
5207600;GO;Fazenda Nova;7093;3248;3070;4074;2244;6318;5471
5207808;GO;Firminópolis;9909;5715;5888;8791;2812;11603;13604
5207907;GO;Flores de Goiás;7514;6642;5416;3175;8883;12058;17415
5208004;GO;Formosa;78651;49965;50119;92035;8049;100084;125705
5208103;GO;Formoso;5589;2481;2410;3615;1276;4891;4098
5208152;GO;Gameleira de Goiás;0;1724;1551;1094;2181;3275;3923
5208301;GO;Divinópolis de Goiás;5172;2596;2371;3492;1475;4967;4701
5208400;GO;Goianápolis;10671;5439;5242;9677;1004;10681;11217
5208509;GO;Goiandira;4967;2641;2627;4542;726;5268;5650
5208608;GO;Goianésia;49160;30067;29478;55665;3880;59545;72045
5208707;GO;Goiânia;1093007;620816;681076;1296969;4923;1301892;1555626
5208806;GO;Goianira;18719;17100;16961;33455;606;34061;46278
5208905;GO;Goiás;27120;12277;12468;18664;6081;24745;22122
5209101;GO;Goiatuba;31130;16218;16263;29934;2547;32481;34307
5209150;GO;Gouvelândia;4009;2565;2383;3894;1054;4948;6076
5209200;GO;Guapó;13863;6983;7019;11354;2648;14002;14206
5209291;GO;Guaraíta;2794;1187;1185;1442;930;2372;1905
5209408;GO;Guarani de Goiás;4678;2294;1968;1764;2498;4262;3801
5209457;GO;Guarinos;2844;1227;1079;1133;1173;2306;1681
5209606;GO;Heitoraí;3445;1826;1742;2643;925;3568;3742
5209705;GO;Hidrolândia;13086;8937;8461;10455;6943;17398;22533
5209804;GO;Hidrolina;4548;2043;1986;2980;1049;4029;3450
5209903;GO;Iaciara;11295;6380;6058;9300;3138;12438;14215
5209937;GO;Inaciolândia;5239;2918;2784;4818;884;5702;6275
5209952;GO;Indiara;11816;7084;6619;11667;2036;13703;15962
5210000;GO;Inhumas;43897;23620;24592;45079;3133;48212;53655
5210109;GO;Ipameri;22628;12444;12301;21337;3408;24745;27365
5210158;GO;Ipiranga de Goiás;0;1451;1393;1272;1572;2844;2892
5210208;GO;Iporá;31300;15307;15967;28545;2729;31274;31471
5210307;GO;Israelândia;3004;1464;1424;2250;638;2888;2772
5210406;GO;Itaberaí;27879;17880;17532;29802;5610;35412;44329
5210562;GO;Itaguari;4385;2275;2233;3963;545;4508;4684
5210604;GO;Itaguaru;5696;2736;2693;4515;914;5429;5184
5210802;GO;Itajá;6572;2510;2556;3744;1322;5066;4412
5210901;GO;Itapaci;13931;9408;9073;16698;1783;18481;23850
5211008;GO;Itapirapuã;10856;3972;3879;5548;2303;7851;4380
5211206;GO;Itapuranga;26740;12901;13184;21213;4872;26085;25597
5211305;GO;Itarumã;5446;3317;2981;4078;2220;6298;7337
5211404;GO;Itauçu;8277;4234;4315;6426;2123;8549;8968
5211503;GO;Itumbiara;81430;45825;47117;89000;3942;92942;106845
5211602;GO;Ivolândia;2992;1405;1258;1535;1128;2663;2295
5211701;GO;Jandaia;6342;3175;2989;4154;2010;6164;6001
5211800;GO;Jaraguá;33284;21249;20639;35318;6570;41888;52160
5211909;GO;Jataí;75451;43998;44050;81044;7004;88048;103221
5212006;GO;Jaupaci;3154;1517;1483;2358;642;3000;2843
5212055;GO;Jesúpolis;2123;1201;1092;1827;466;2293;2497
5212105;GO;Joviânia;6904;3598;3510;6462;646;7108;7417
5212204;GO;Jussara;20034;9547;9539;15138;3948;19086;18266
5212253;GO;Lagoa Santa;0;643;616;778;481;1259;1652
5212303;GO;Leopoldo de Bulhões;7766;4008;3867;4843;3032;7875;7663
5212501;GO;Luziânia;141082;87108;87438;162835;11711;174546;214645
5212600;GO;Mairipotaba;2403;1241;1137;1573;805;2378;2358
5212709;GO;Mambaí;4838;3541;3344;4814;2071;6885;9277
5212808;GO;Mara Rosa;11939;5431;5228;7963;2696;10659;9234
5212907;GO;Marzagão;1920;1026;1046;1804;268;2072;2263
5212956;GO;Matrinchã;4520;2254;2160;2995;1419;4414;4321
5213004;GO;Maurilândia;8969;6026;5490;11116;400;11516;14568
5213053;GO;Mimoso de Goiás;2801;1427;1258;1242;1443;2685;2575
5213087;GO;Minaçu;33608;15816;15333;26546;4603;31149;28518
5213103;GO;Mineiros;39024;27199;25765;48327;4637;52964;69477
5213400;GO;Moiporá;2023;899;864;1133;630;1763;1471
5213509;GO;Monte Alegre de Goiás;6892;3990;3752;3174;4568;7742;8759
5213707;GO;Montes Claros de Goiás;7991;4110;3890;5328;2672;8000;8037
5213756;GO;Montividiu;7736;5500;5076;8592;1984;10576;13935
5213772;GO;Montividiu do Norte;3789;2104;2010;1347;2767;4114;4538
5213806;GO;Morrinhos;36990;20766;20691;35956;5501;41457;46955
5213855;GO;Morro Agudo de Goiás;2489;1179;1186;1658;707;2365;2217
5213905;GO;Mossâmedes;5798;2557;2448;3273;1732;5005;4120
5214002;GO;Mozarlândia;11186;6850;6553;12162;1241;13403;16077
5214051;GO;Mundo Novo;8109;3415;3007;3768;2654;6422;4540
5214101;GO;Mutunópolis;3958;1996;1846;2538;1304;3842;3749
5214408;GO;Nazário;6631;3963;3911;6187;1687;7874;9375
5214507;GO;Nerópolis;18578;11928;12261;23208;981;24189;30931
5214606;GO;Niquelândia;38573;21678;20702;33346;9034;42380;47064
5214705;GO;Nova América;2185;1158;1096;1643;611;2254;2362
5214804;GO;Nova Aurora;1927;1074;995;1880;189;2069;2236
5214838;GO;Nova Crixás;11061;6217;5694;7702;4209;11911;13020
5214861;GO;Nova Glória;8944;4248;4266;5728;2786;8514;8063
5214879;GO;Nova Iguaçu de Goiás;2746;1455;1371;2024;802;2826;2939
5214903;GO;Nova Roma;3717;1793;1675;1423;2045;3468;3208
5215009;GO;Nova Veneza;6414;4128;4001;7026;1103;8129;10193
5215207;GO;Novo Brasil;4181;1817;1699;2275;1241;3516;2775
5215231;GO;Novo Gama;74380;46672;48341;93967;1046;95013;119649
5215256;GO;Novo Planalto;3432;2075;1878;2587;1366;3953;4592
5215306;GO;Orizona;13067;7375;6917;7981;6311;14292;15834
5215405;GO;Ouro Verde de Goiás;4358;2010;2030;2683;1357;4040;3679
5215504;GO;Ouvidor;4271;2804;2642;4795;651;5446;6895
5215603;GO;Padre Bernardo;21514;14000;13689;10794;16895;27689;35011
5215652;GO;Palestina de Goiás;3307;1779;1603;2180;1202;3382;3470
5215702;GO;Palmeiras de Goiás;17822;11813;11520;19154;4179;23333;29915
5215801;GO;Palmelo;2309;1152;1187;2216;123;2339;2382
5215900;GO;Palminópolis;3561;1779;1782;2699;862;3561;3578
5216007;GO;Panamá;2776;1367;1309;2035;641;2676;2590
5216304;GO;Paranaiguara;8192;4598;4521;8397;722;9119;10221
5216403;GO;Paraúna;10834;5517;5343;7987;2873;10860;10988
5216452;GO;Perolândia;2791;1570;1380;1859;1091;2950;3156
5216809;GO;Petrolina de Goiás;10381;5364;4921;6684;3601;10285;10240
5216908;GO;Pilar de Goiás;3339;1467;1299;1198;1568;2766;2135
5217104;GO;Piracanjuba;23557;12204;11829;17553;6480;24033;24543
5217203;GO;Piranhas;12287;5719;5549;9071;2197;11268;10161
5217302;GO;Pirenópolis;21245;11826;11239;15589;7476;23065;25218
5217401;GO;Pires do Rio;26229;14071;14620;27018;1673;28691;31909
5217609;GO;Planaltina;73718;40491;41121;77583;4029;81612;91345
5217708;GO;Pontalina;16556;8567;8545;13890;3222;17112;17899
5218003;GO;Porangatu;39593;21285;21071;35742;6614;42356;45866
5218052;GO;Porteirão;2823;1808;1539;2929;418;3347;3979
5218102;GO;Portelândia;3696;1986;1853;3110;729;3839;4032
5218300;GO;Posse;25696;15927;15490;23934;7483;31417;37924
5218391;GO;Professor Jamil;3403;1678;1566;2263;981;3244;3211
5218508;GO;Quirinópolis;36512;21940;21303;38179;5064;43243;51323
5218607;GO;Rialma;10210;5230;5286;9794;722;10516;10961
5218706;GO;Rianápolis;4364;2312;2244;4071;485;4556;4832
5218789;GO;Rio Quente;2097;1732;1579;2838;473;3311;4728
5218805;GO;Rio Verde;116552;90021;86481;163621;12881;176502;247259
5218904;GO;Rubiataba;18087;9385;9463;16158;2690;18848;20012
5219001;GO;Sanclerlândia;7530;3847;3716;6079;1484;7563;7630
5219100;GO;Santa Bárbara de Goiás;4963;2932;2819;5206;545;5751;6701
5219209;GO;Santa Cruz de Goiás;3470;1645;1497;981;2161;3142;2782
5219258;GO;Santa Fé de Goiás;4083;2411;2357;3823;945;4768;5585
5219308;GO;Santa Helena de Goiás;34545;18311;18148;34810;1649;36459;38962
5219357;GO;Santa Isabel;3592;1900;1780;1361;2319;3680;3821
5219407;GO;Santa Rita do Araguaia;5087;3549;3379;6163;765;6928;9110
5219456;GO;Santa Rita do Novo Destino;3025;1725;1445;1114;2056;3170;3367
5219506;GO;Santa Rosa de Goiás;3548;1451;1454;2177;728;2905;2200
5219605;GO;Santa Tereza de Goiás;4697;1993;1998;3351;640;3991;3207
5219704;GO;Santa Terezinha de Goiás;12015;5261;5043;7768;2536;10304;8386
5219712;GO;Santo Antônio da Barra;4052;2350;2080;3384;1046;4430;4886
5219738;GO;Santo Antônio de Goiás;3106;2379;2311;4258;432;4690;6593
5219753;GO;Santo Antônio do Descoberto;51897;31340;31826;56721;6445;63166;76871
5219803;GO;São Domingos;9636;5903;5333;5745;5491;11236;13305
5219902;GO;São Francisco de Goiás;6028;3142;2975;4461;1656;6117;6265
5220009;GO;São João dAliança;6736;5273;4981;6721;3533;10254;14423
5220058;GO;São João da Paraúna;2024;845;847;1277;415;1692;1312
5220108;GO;São Luís de Montes Belos;26383;14743;15307;26601;3449;30050;34488
5220157;GO;São Luíz do Norte;4089;2334;2283;3908;709;4617;5263
5220207;GO;São Miguel do Araguaia;22793;11397;10897;17668;4626;22294;21849
5220264;GO;São Miguel do Passa Quatro;3481;1945;1816;2076;1685;3761;4105
5220280;GO;São Patrício;1835;1000;991;1171;820;1991;2040
5220405;GO;São Simão;13552;8863;8223;16307;779;17086;21318
5220454;GO;Senador Canedo;53105;42184;42215;84066;333;84399;121447
5220504;GO;Serranópolis;6447;3971;3506;5540;1937;7477;8737
5220603;GO;Silvânia;20339;9811;9285;12679;6417;19096;20938
5220686;GO;Simolândia;6219;3301;3211;5377;1135;6512;6895
5220702;GO;Sítio dAbadia;2681;1517;1304;994;1827;2821;3040
5221007;GO;Taquaral de Goiás;3587;1766;1774;2876;664;3540;3506
5221080;GO;Teresina de Goiás;2585;1542;1474;2134;882;3016;3538
5221197;GO;Terezópolis de Goiás;5083;3347;3215;5677;885;6562;8326
5221304;GO;Três Ranchos;2831;1423;1394;2486;331;2817;2830
5221403;GO;Trindade;81457;51407;53099;100107;4399;104506;132006
5221452;GO;Trombas;3434;1778;1657;2183;1252;3435;3497
5221502;GO;Turvânia;5134;2431;2408;3891;948;4839;4526
5221551;GO;Turvelândia;3524;2338;2061;3138;1261;4399;5447
5221577;GO;Uirapuru;3043;1527;1408;1464;1471;2935;2829
5221601;GO;Uruaçu;33530;18443;18506;33816;3133;36949;41150
5221700;GO;Uruana;13938;7004;6817;11227;2594;13821;13795
5221809;GO;Urutaí;3104;1560;1498;2165;893;3058;3056
5221858;GO;Valparaíso de Goiás;94856;64616;68331;132947;0;132947;175720
5221908;GO;Varjão;3519;1854;1807;2245;1416;3661;3848
5222005;GO;Vianópolis;11300;6284;6265;9164;3385;12549;14088
5222054;GO;Vicentinópolis;6015;3871;3500;6322;1049;7371;9002
5222203;GO;Vila Boa;3287;2606;2136;3497;1245;4742;6451
5222302;GO;Vila Propício;4492;2690;2455;1504;3641;5145;5941
5300108;DF;Brasília;2051146;1225237;1337726;2476249;86714;2562963;3094325
